1
The Mystic number of Kether. S. P. M.

2
S. S. F.
	א:א: (A:A:): [Abbreviation for 422, ARYK ANPYN, q.v.]

3
♄. The Mystic Number of Chokmah
	אב (AB): Father
	בא (BA): To come, go

4
The Number of Abra-Melin Princes. ♃.
	אבא (ABA): Father
	בב (BB): Hollow; a vein
	גא (GA): Proud

5
♂
	אד (AD): Mist, vapour
	בג (BG): Back

6
☉. The Mystic Number of Binah
	גבא (GBA): To gather, collect
	גג (GG): Gog, the giant whose partner is Magog
	דב (DB): A bear
	הא (HA): A window

7
♀
	אבד (ABD): Lost, ruined
	אהא (AHA): A name of GOD attributed to ♀. Initials of Adonai ha-Aretz
	או (AV): Desire; either, or
	גד (GD): Gad, a Tribe of Israel; good fortune
	דאב (DAB): Was weary
	דבא (DBA): Riches, power
	דג (DG): Fish

8
The Number of Abra-Melin Sub-Princes, and of the Servitors of Oriens. ☿
	אבה (ABH): To will, intend
	אהב (AHB): Desired, beloved
	אוא (AVA): 
	אז (AZ): Then
	באה (BAH): The entrance, threshold
	דאג (DAG): To be anxious, grieve
	דד (DD): Love; beloved, breast; pleasures of love
	זא (ZA): Nqn. Zauir Anpin 478 q.v.

9
♄. ☽
	אוב (AVB): Ventriloquus: the special 'fire' of black magic, whence Obi, Obeah. Cf. 11 and 207
	אזא (AZA): He kindled
	אח (ACh): Brother
	בגד (BGD): A garment
	גאה (GAH): Became powerful, grew high
	גו (GV): Middle
	הד (HD): Splendour; cf. 15

10
The Mystic Number of Chesed. Elementorum Sphaera. The Number of Abra-Melin Servitors of Amaimon and Ariton
	אט (AT): Enchanter
	בגה (BGH): [Vide K.D. L.C.K. p. 185]
	גבה (GBH): Elevated, exalted, high
	דאה (DAH): Flew, soared
	דו (DV): Two
	הה (HH): Window
	זאב (ZAB): A wolf
	חב (ChB): A hidden place; bosom

11

	אהה (AHH): Ahah
	אוד (AVD): Firebrand, volcanic fire: the Special 'fire' or 'light' of the Sacred Magic of Light, Life, and Love; hence "Odic Force" &c. Cf. 9 and 207
	אי (AY): Where
	בבוא (BBVA): When
	גדד (GDD): To tear, cut, attack
	דהב (DHB): Gold (Ch.)
	זד (ZD): Proud, haughty
	חבא (ChBA): To conceal
	חג (ChG): A circularity of form or motion; a feast

12

	אוה (AVH): He longed for, missed
	אזד (AZD): He departed, went forth
	גט (GT): A little book, pamphlet, letter; tools
	דגה (DGH): To multiply
	הבה (HBH): A city of Edom
	הוא (HVA): HE. [HB:H is referred to Mater, HB:V to Pater, HB:A to Corona]
	וו (VV): Vau; hook, nail, pin
	זה (ZH): This, that
	חד (ChD): To penetrate, be sharp; (Ch.) one

13

	אגדה (AGDH): A small bundle, bunch
	אהבה (AHBH): Beloved; Love
	אחד (AChD): Unity
	איב (AYB): Hated
	בהו (BHV): Emptiness
	גהה (GHH): Raised up
	גי (GY): Chokmah, 42-fold Name in Yetzirah. (See 777)
	דאגה (DAGH): Anxiety
	דוג (DVG): A fisher
	הגה (HGH): Thunder; to meditate; he remembers
	הדד (HDD): A city of Edom
	זו (ZV): Here; this
	חגב (ChGB): A locust
	יבא (YBA): He shall come

14

	אטד (ATD): Rhamnus; a thorn, spine
	גיא (GYA): Rising ground; Earth of Geburah. (See 777)
	דבח (DBCh): Sacrifice v. s. (Ch.). (?)
	דוד (DVD): Love, beloved: David
	הב הב (HB HB): Give, give! [Vide no. 17, YHB}
	הדה (HDH): To grind, direct, stretch out
	זהב (ZHB): Gold
	יד (YD): Hand

15
SUM (1 - (3x3)) / 3. The Mystic Number of Geburah. The Number of Abra-Melin Servitors of Asmodee and Magot, and of Paimon
	אבוהא (ABVHA): Angel of 3rd Dec. ♐
	אביב (ABYB): The month of Exodus and Passover
	איד (AYD): Steam, vapour
	גאוה (GAVH): Pride; a carrying out; exaltation
	הוד (HVD): Splendour, the Eighth Sephira
	זוב (ZVB): Overflowing, abounding
	זח (ZCh): He who impels; to force
	חבה (ChBH): To hide
	יה (YH): The Monogram of the Eternal

16
The Number of Abra-Melin Servitors of Asmodee
	אזוב (AZVB): Hyssopus
	אחז (AChZ): He seized, cleaved to
	גבוה (GBVH): Elevated, exalted, high
	הוה (HVH): (Verb. subst.) Injury, war, lust; fell
	היא (HYA): She
	וי (VY): Alas! --- Woe
	זוג (ZVG): Like, equal to

17

	אגוז (AGVZ): Nuts
	אוי (AVY): Ah! --- Alas!
	גדי (GDY): Capricornus
	גיד (GYD): Nerve, sinew. [Gen. xxxii. 25 & 32]
	הגדה (HGDH): Narrative, subtle discourse
	ההוא (HHVA): K.D. L.C.K. p. 267
	הזה (HZH): To dream, rave
	זבוב (ZBVB): A fly
	זבח (ZBCh): Sacrificed
	זוד (ZVD): To seethe, boil
	חדה (ChDH): To brighten, make joyful
	חוג (ChVG): A circle, orbit
	טוב (TVB): Good
	יהב (YHB): To give, place

18

	אהבי (AHBY): My favourite, my beloved
	איבה (AYBH): Hatred
	חטא (ChTA): The antique Serpent
	חי (ChY): Living
	יאוא (YAVA): Notariqon of Yehi Aur, etc.

19

	אהוז (AHVZ): Angel L.T.D. of ♐
	אויב (AVYB): An enemy
	איוב (AYVB): Job
	דיה (DYH): Was black
	חוה (ChVH): Chavvah; to manifest, shew forth; Eve

20
The Number of Abra-Melin Servitors of Amaimon
	אחוה (AChVH): Fraternity
	דיו (DYV): Black liquid
	היה (HYH): It was
	חזה (ChZH): The breast; a vision; a prophet to gaze
	יובב (YVBB): Jobab, an Edomite King
	יוד (YVD): The hand

21
The Mystic Number of Tiphareth
	אהיה (AHYH): Existence, Being, the Kether- name of GOD
	אכ (AK): But, yet, certainly
	הגיג (HGYG): Deep meditation
	הוי (HVY): Ah! --- Alas!
	זחו (ZChV): Purity, innocence
	יהו (YHV): Yide Sepher Yetzirah

22
The Number of Abra-Melin Servitors of Ariton
	בידו (BYDV): With his hand; Night Demon of 1st Dec. ♋
	ביוד (BYVD): By Yodh
	האאיה (HAAYH): Hearer in secret; Angel of 8 W.
	זווג (ZVVG): The state of puberty
	חזוא (ChZVA): A magical vision (Ch.)
	חטה (ChTH): Wheat
	טובה (TVBH): Good
	יאיא (YAYA): Notariqon of "Tet. Elohim Tet. Achad."
	יחד (YChD): Unity

23

	זחח (ZChCh): Parted, removed, separated
	חדוה (ChDVH): Joy
	חוט (ChVT): A thread
	חיה (ChYH): Life

24
The Number of the 'Elders' in the Apocalypse
	אהובי (AHVBY): He whom I love
	אוהבי (AVHBY): He who loves me
	אזבוגה (AZBVGH): A Mercurial GOD. His essence is HB:AZ , 8
	גויה (GVYH): Substance; a body
	דכ (DK): A pauper
	הבביה (HBBYH): Angel of 2 C.
	זיז (ZYZ): Abundance
	כד (KD): A water-pot, a large earthenware vessel

25

	דכא (DKA): To break
	חיוא (ChYVA): The Beast
	יהוד (YHVD): Jehewid, God of Geburah of Binah<>
	יהי (YHY): Let there be
	יזח (YZCh): Will be separated
	כה (KH): Thus

26
The Numbers of the Sephiroth of the Middle Pillar, 1 + 6 + 9 + 10
	הויה (HVYH): [Vide K.D. L.C.K. p. 273]
	חוזה (ChVZH): Seeing, looking at
	חזוה (ChZVH): Sight, vision
	יהוה (YHVH): TETRAGRAMATON, "Jehovah," the Unutterable Name, the Lost Word
	כבד (KBD): Kebad, husband of the impure Lilith. [K.D. L.C.K. 464]

27
3rd Rt
	בכה (BKH): Wept, mourned
	זכ (ZK): Purity
	חידה (ChYDH): A parable, enigma, riddle

28
The Mystic Number of Netzach
	טיט (TYT): Clay
	יחוד (YChVD): Union, unity
	כח (KCh): Power

29

	דכה (DKH): Is broken. [Ps. x. 10]
	הדכ (HDK): To break down, overturn

30

	חייב (ChYYB): A party to an action at law; defendant, plaintiff. [Note HB:L = 30 = ♎ = 'Justice']
	יהודה (YHVDH): Judah
	יהיה (YHYH): It will be

31

	איכ (AYK): How?
	אל (AL): GOD of Chesed and of Kether of Briah
	הוכ (HVK): To go
	הכאה (HKAH): A beating, striking, collision
	ויהי (VYHY): And there was. [Vide S.D.I. par. 31]
	ייאי (YYAY): K. of S. Fig. 31
	לא (LA): Not

32
The Number of Abramelin Servitors 25 of Astarot
	אהיהוה (AHYHVH): Coalescence of AHYH and YHVH Macroprosopus and Microprosopus. This is symbolized by the Hexagram. Suppose the 3 HB:H's conceal the 3 Mothers HB:A, HB:M & HB:Sh and we get 358 q.v.
	בל (BL): Lord
	והויה (VHVYH): Angel of 5 W.
	זיווג (ZYVVG): Copula Maritalis
	זכה (ZKH): Was pure
	חזיז (ChZYZ): Zig-zag, fork-lightning
	יחיד (YChYD): Unity K.D. L.C.K. p. 432
	כבוד (KBVD): Glory
	לב (LB): Mind, heart

33

	אבל (ABL): Sorrow; wept, mourned
	באל (BAL): Day Demon of 1st Dec. ♈
	בלא (BLA): To destroy (Ch.); (?) a King of Edom
	גל (GL): Spring, fountain

34
SUM (1 - (4 x 4)) / 4. ♃
	אל אב (AL AB): "GOD the Father," divine name attributed to ♃
	גאל (GAL): To ransom, avenge, pollute
	גלא (GLA): To reveal
	דל (DL): A pauper
	הדיוט (HDYVT): A common person; uneducated, ignorant
	חהויה (ChHVYH): Angel of 1 C.

35

	אגלא (AGLA): Agla, a name of God; notariqon of Ateh Gibor le-Olahm Adonai
	גבל (GBL): Boundary, limit
	יהכ (YHK): He will go

36
= ☉. The Mystic Number of Hod
	אהל (AHL): Tabernaculum
	איכה (AYKH): How? (Vide Lamentations)
	אלה (ALH): Duke of Geburah in Edom; to curse; name of GOD attributed to ☿
	הלא (HLA): To remove, cast away
	וידוי (VYDVY): Confession
	לאה (LAH): Leah
	לו (LV): Perhaps, possibly; would that!

37

	אכאיה (AKAYH): Angel of 8 P.
	אלהא (ALHA): GOD (Ch.)
	אלו (ALV): Behold!
	בלה (BLH): Perished, grew old
	גדל (GDL): To grow great
	דגל (DGL): Banner
	הבל (HBL): Tenuity, breath, vanity; in vain; Abel. [I.Z.Q., "The Supernal Breathers."]
	ואל (VAL): Night Demon of 2nd Dec. ♐
	זל (ZL): Profession
	יחידה (YChYDH): Jechidah, the Atma of Hindu philosophy
	להב (LHB): Flame
	לז (LZ): (?) Devotion of force

38

	אואל (AVAL): Night Demon of 2nd Dec. ♋
	אזל (AZL): He departed
	גיחזי (GYChZY): Gehazi, servant of Elisha
	גלה (GLH): A City in the Mountains of Judah
	זכאי (ZKAY): Innocent
	חיכ (ChYK): The palate
	חל (ChL): To make a hole, hollow; to violate
	לח (LCh): Green

39

	זבל (ZBL): To abide, dwell
	טל (TL): Dew
	יהוה אחד (YHVH AChD): The Eternal is One
	יחויה (YChVYH): Angel of 3 P.
	כוזו (KVZV): Metathesis of YHVH
	לט (LT): He cursed

40

	בלדד (BLDD): Bildad
	גואל (GVAL): Liberator; title of Jesod
	גזל (GZL): To cut off
	חבל (ChBL): A rope; ruin; to bind
	חלב (ChLB): Milk
	יד יהוה (YD YHVH): The Hand of the Eternal
	לי (LY): To me, to mine

41

	אחלב (AChLB): Fecundity
	איל (AYL): Ram; force; hence = a hero
	אלוד (ALVD): Night Demon of 1st Dec. ♍
	אלי (ALY): My GOD
	אמ (AM): Mother
	בטל (BTL): To fail, cease
	גאואל (GAVAL): Divine Majesty
	גבול (GBVL): Terminus
	גחל (GChL): To burn
	הול (HVL): Terror
	חגל (ChGL): To go round in a circle
	יה יהוה (YH YHVH): [Vide Ps. cxviii. & I.R.Q. 778]

42
The Number of the letters of a great name of GOD terrible and strong, and of the Assessors of the Dead
	איאל (AYAL): Angel of
	אלוה (ALVH): Eloah, a name of GOD
	אמא (AMA): The Supernal Mother, unfertilized; see 52
	בלהה (BLHH): Terror, calamity
	בלי (BLY): Loss, destruction
	חדל (ChDL): To cease
	חלד (ChLD): The World, Earth of Malkuth
	כבודי (KBVDY): My glory

43

	גדול (GDVL): Great
	גיל (GYL): To rejoice
	חלה (ChLH): Challah; to make faint. [Vide K.D. L.C.K. p. 346]
	לביא (LBYA): [Vide K.D. L.C.K, p. 151; see no. 340]
	לוז (LVZ): Hazel, almond

44
220 / 5
	אגלי (AGLY): Drops
	אגמ (AGM): A pool, pond; sorrow
	גולה (GVLH): Captive, captivity
	גיאל (GYAL): Angel ruling ♊
	דלי (DLY): ♒
	דמ (DM): Blood
	חול (ChVL): Sand: also horror. See ♏n Pantacle in K. of S. and 10th Aethyr
	טלה (TLH): A ram; ♈
	יוד הא וו הא (YVD HA VV HA): Tet. in ? World. [Vide K.D. L.C.K. p. 251]
	להט (LHT): Flame

45
The Mystic Number of Jesod
	אגיאל (AGYAL): Intelligence of ♄
	אדמ (ADM): Adam
	אמד (AMD): The Fool
	גאולה (GAVLH): Redemption, liberation
	המ (HM): To grow warm
	זבול (ZBVL): Heaven of Tiphareth
	זחל (ZChL): Hesitated. [Vide no. 405]
	זזאל (ZZAL): Spirit of ♄
	חבלה (ChBLH): She who ruins
	יוד הא ואו הא (YVD HA VAV HA): Tet. in Yetzirah
	מאד (MAD): Greatly, strongly
	מה (MH): Yetzirah's 'Secret Nature' [Vide I.R.Q. xxxiv.]

46

	אלהי (ALHY): A name of GOD
	אמה (AMH): A female slave; cubitus
	בדיל (BDYL): Tin, the metal of ♃
	הבדלה (HBDLH): A dividing, sundering, separation
	הההאל (HHHAL): Angel of 7 S.
	חובל (ChVBL): A ruiner
	טואל (TVAL): Angel ruling ♉
	לוי (LVY): Levi, Levite

47

	אויל (AVYL): Foolish, silly. (Stultus)
	בכייה (BKYYH): A weeping
	במה (BMH): Cloud; high place; waves; fortress
	יואל (YVAL): Angel ruling ♍
	חלט (ChLT): To clutch, hold

48

	גדולה (GDVLH): Mercy
	והואל (VHVAL): Angel of 2 W.
	חיל (ChYL): A woman [vide K.D. L.C.K. p. 320]; strength; an army
	חמ (ChM): To grow warm; heat, fire; black; Ham, the son of Noah
	יובל (YVBL): Jubilee
	כוכב (KVKB): A star, planet; Sphere of ☿
	מאז (MAZ): [Vide Ps. xciii, & Prov. viii. 22]

49
The Number of Abra-Melin Servitors of Beelzebub. ♀
	לא חי (LA ChY): The Living GOD
	גולחב (GVLChB): Qliphoth of Geburah
	דמה (DMH): Resembled; meditated; silent
	הגיאל (HGYAL): Intelligence of ♀
	חולה (ChVLH): Drooping, being sick
	חילא (ChYLA): Strength
	חמא (ChMA): Heat, fury (Ch.)
	לידה (LYDH): A bringing forth, birth, nativity
	מדה (MDH): A measuring, measure
	מוג (MVG): Solve. Vide no. 103]
	מט (MT): The Rod of Aaron

50

	אדמה (ADMH): Red earth, the soil; Earth of Chesed
	אטמ (ATM): Closed, shut up
	אלדיה (ALDYH): Angel of 9 P.
	דג גדול (DG GDVL): Jonah's Whale
	המה (HMH): To ferment
	חבלי (ChBLY): Pains, sorrows
	טמא (TMA): Unclean, impure
	ייל (YYL): 58th HB:Sh
	ילי (YLY): 2nd HB:Sh
	ימ (YM): The sea
	כל (KL): All, every
	לכ (LK): To thee
	מי (MY): What? --- Which?

51

	אדומ (ADVM): Edom
	אימ (AYM): Terrible; Day Demon of 2nd Dec. ♏
	אכל (AKL): Ate; devoured
	אנ (AN): Pain
	הומ (HVM): Tumultuously (vide no. 451); to harass, perturb
	יההאל (YHHAL): Angel of 8 S. [Vide K. of S., fig. 52]
	נא (NA): Failure

52

	אבא ואמא (ABA VAMA): Father and Mother
	אימא (AYMA): Supernal Mother
	אליהו (ALYHV): Elihu - Eli Hua, "He is my GOD," who is the Holy Guardian Angel of Job in the Alegory
	אנא (ANA): [Vide K.D. L.C.K. p. 134]
	בהמה (BHMH): A mare; brute animal, beast
	בימ (BYM): Day Demon of 2nd Dec. ♐
	בכל (BKL): From all, among all
	בנ (BN): The Son: Assiah's "Secret Nature"
	זמה (ZMH): Meditation, imagination, sin
	חמד (ChMD): A desirable one; to desire
	יבמ (YBM): A husband's brother
	יהואל (YHVAL): Angel of Kether of Binah, <> and of Jesod of Binah <>
	יוד הה וו הה (YVD HH VV HH): Tet. in Assiah
	כלב (KLB): A dog
	לאויה (LAVYH): Angel of 4 C., and of 10 P.

53
The Number of Abra-Melin Servitors of Astarot and Asmodee
	אבנ (ABN): The stone that slew Goliath; a stone, rock
	אליהוא (ALYHVA): Elihu. (Vide 52)
	גנ (GN): The garden
	הזיאל (HZYAL): Angel of 9 P.
	חמה (ChMH): To defend, hide; a wall; the sun; fury
	טחול (TChVL): The spleen
	מאהבה (MAHBH): A lover

54

	אגנ (AGN): A basin, bowl, vessel. [Ex. xxiv. 6]
	דמי (DMY): Rest
	דנ (DN): A Tribe of Israel; to judge, rule. [Vide K.D. L.C.K. p.37]
	חומ (ChVM): Pertaining to summer
	להטי (LHTY): My flame; enchantments
	מטה (MTH): A bed; stick, rod
	נד (ND): To remove

55
The Mystic Number of Malkuth
	גנב (GNB): Thief; stole
	גזילה (GZYLH): Robbery, pillage
	דומה (DVMH): Silence. [For name of Angels, see Sohar Sch. V. Cap. 18]
	הדומ (HDVM): A footstool
	הימ (HYM): To swell, heave. [Vide no. 51]
	הלכ (HLK): To walk
	חוליא (ChVLYA): Knuckle; member, limb
	כלה (KLH): The bride
	נגב (NGB): Noon; midday
	נה (NH): Ornament

56

	אימה (AYMH): Dread, terror
	אנה (ANH): He suffered
	הייאל (HYYAL): Angel of 4 C.
	יומ (YVM): Day
	נאה (NAH): Beautiful

57

	אבדנ (ABDN): Rim
	אוכל (AVKL): Consuming
	אונ (AVN): Wealth, an age, Time; Night Demon of 1st Dec. ♏
	איומ (AYVM): Formidable, terrible
	אנו (ANV): We
	ביטול (BYTVL): A breaking down, subversion, destruction
	בנה (BNH): Built
	דגימ (DGYM): ♓. [Fish (pl.); vide 7]
	ווליה (VVLYH): Angel of 8 C.
	לוויה (LVVYH): Angel of 5 C.
	מזבח (MZBCh): Altar
	מחבוא (MChBVA): The laying-by, making secret

58

	אהבימ (AHBYM): [Vide no. 499]
	אזנ (AZN): [Vide K.D. L.C.K. p. 69] An ear
	דאגנ (DAGN): Night Demon of 1st Dec. ♐
	חילי (ChYLY): My strength, power, might
	חנ (ChN): Love, kindness, grace; notariqon of Chokmah Nesthrah, the Secret Wisdom
	טליהד (TLYHD): Ruler of Water
	ייזאל (YYZAL): Angel of 6 S.
	להחיה (LHChYH): Angel of 3 P.
	נח (NCh): [Vide K.D. L.C.K. p. 69]

59

	אחימ (AChYM): Brethren. [Referred to Lilith & Samael --- K.D. L.C.K. p. 54]
	גוימ (GVYM): Heathen
	חומה (ChVMH): A wall
	נדה (NDH): Menstruata

60

	בחנ (BChN): Tried by fire; a watch-tower
	גאונ (GAVN): Excellence, sublimity, glory, pride
	הלכה (HLKH): Constitution, tradition
	הנה (HNH): To behold
	טנא (TNA): A basket
	ילהיה (YLHYH): Angel of 8 C.
	מחזה (MChZH): Vision
	נגבה (NGBH): The Southern district

61

	אדונ (ADVN): Master, Lord, Adon
	אינ (AYN): The Negative, non-existent; not
	אליכ (ALYK): Towards, to thee
	אני (ANY): I, myself
	בטנ (BTN): The belly
	דמביה (DMBYH): Angel of 10 S.
	הונ (HVN): Wealth
	יייאל (YYYAL): Angel of 6 C.
	נוה (NVH): Habitaculum

62

	אסא (ASA): Healing
	בההמי (BHHMY): Angel of 2nd Dec. ♈
	בני (BNY): The sons
	זנה (ZNH): To commit; healing

63

	אבדונ (ABDVN): Abaddon, The Hell of Chesed
	גלל (GLL): Dregs, roll; faeces (globular); dung
	זונ (ZVN): Fed
	חוטמ (ChVTM): The nose
	חימה (ChYMH): Fervour
	יוד הי ואו הי (YVD HY VAV HY): Tet. in Briah
	סג (SG): Briah's "Secret Nature"

64
= 4 to the 3rd power = 2 to the 6th power. ☿
	אנחה (ANChH): A sigh, groan, deep breath
	דינ (DYN): Justice
	דני (DNY): (Din and Doni are twin Mercurial Intelligences in ♊)
	מי זהב (MY ZHB): The golden waters
	מיזהב (MYZHB): [I.R.Q. xl. 996]
	נבואה (NBVAH): Prophecy
	נוגה (NVGH): Sphere of ♀
	נוח (NVCh): Noach

65
SUM (1 - (5 x 5)) / 5. The Number of Abra-Melin Servitors of Magot and Kore
	אדני (ADNY): Adonai
	אוחימ (AVChYM): Weasels and other terrible animals
	היכל (HYKL): The Palace
	הלל (HLL): Shone, gloried, praised
	הס (HS): To keep silence
	חזנ (ChZN): Defective. [Vide K.D. L.C.K. p. 339]
	ללה (LLH): 6th HB:Sh
	מזוזה (MZVZH): A door post
	מכה (MKH): A beating, striking
	נהי (NHY): [Vide K.D. L.C.K. p. 563]

66
The Mystic Number of the Qliphoth, and of the Great Work.
	אכילה (AKYLH): Food, vituals
	אלהיכ (ALHYK): The Lord thy GOD (is a consuming Fire). [Deut.iv.24]
	אניה (ANYH): A ship
	בחונ (BChVN): A trial, an experiment
	גלגל (GLGL): A wheel. [Called "Cognomen Schechinae"]
	דנהבה (DNHBH): A City of Edom

67

	אוני (AVNY): [Vide K.D. L.C.K. p. 57]
	בינה (BYNH): The Understanding
	וינא (VYNA): Night Demon of 3rd Dec. ♊
	זינ (ZYN): Zayin
	זלל (ZLL): Debased
	חנט (ChNT): To embalm
	יבמיה (YBMYH): Angel of 3 C.

68

	ויבנ (VYBN): Wise. --- Intelliget ista?
	חכמ (ChKM): To be wise
	חלל (ChLL): Emptiness
	חס (ChS): To pity
	לולב (LVLB): Ramus Tabernacularis

69

	אבוס (ABVS): A manger, stable; an enclosure
	הדס (HDS): Myrtle
	וכבילא (VKBYLA): L.A. Angel of ♓

70

	אדניה (ADNYH): (A proper name)
	הסה (HSH): Hush, be silent
	יינ (YYN): Wine
	ליל (LYL): Night
	סוד (SVD): [Vide Ps. xxv. 14.] The Secret

71

	אימכ (AYMK): Thy terror
	אליל (ALYL): Nothing; an apparition, image
	אלמ (ALM): Silence; silent
	אמדוכ (AMDVK): Night Demon of 1st Dec. ♒
	אנכ (ANK): Lead, the metal of ♄; a plummet-line, level, water- level.
	חזונ (ChZVN): Vision
	יונה (YVNH): A dove, pigeon
	ינוה (YNVH): A dove
	מלא (MLA): Plentitude, fullness

72
[72 x 3 = 216, ARYH; vide K.D. L.C.K. p. 151.] There are 72 quinaries (spaces of 5 Degree) in the Zodiac. The Shemhamphorasch or 'divided name' of GOD consists of 72 triliteral names, which by adding YH or AL give 72 angels. Vide Lib. DCCLXXVII
	אדונאי (ADVNAY): Adonai, transliterated as by Lemegeton, etc.
	אדוכיאל (ADVKYAL): Geomantic Intelligence of ♐
	בכנ (BKN): In, so, thus, then
	בסוד (BSVD): In the secret
	ויכלו (VYKLV): And they are excellent, finished
	חסד (ChSD): Kindness, mercy
	יוד הי ויו הי (YVD HY VYV HY): Tet. in Atziluth
	מכבי (MKBY): Maccabee
	עב (a'aB): Atziluth's "Secret Nature" --- thickness, cloud; Aub

73

	בליאל (BLYAL): Demon-King of Hod, and Night Demon of 2nd Dec. ♒
	גמל (GML): Gimel
	חכמה (ChKMH): The Wise One
	חסה (ChSH): To trust in, shelter in
	יומ טוב (YVM TVB): A day of feast

74

	דיינ (DYYN): A leader, chief, judge
	דכימ (DKYM): Worn-out (?shameless) Beggars
	למד (LMD): Ox-goad
	סביב (SBYB): A circuit; roundabout
	עד (a'aD): All the way, constantly

75

	גווני (GVVNY): Hues, colours, complexions
	הילל (HYLL): Lucifer, the Herald Star
	יכדיאל (YKDYAL): Vide K. of S., fig. 53]
	יללה (YLLH): A lamenting, wailing
	כימה (KYMH): The Pleiades
	לילה (LYLH): Night; by night
	נויט (NVYT): NUIT, THE STAR GODDESS

76

	חביונ (ChBYVN): Secret, put away; a hiding- place
	ניחח (NYChCh): Rest, peace
	עבד (a'aBD): Slave, servant

77

	בעה (Ba'aH): Prayed
	גיחונ (GYChVN): The river Gihon. [Gen. ii. 13]
	זידונ (ZYDVN): Overflowing. [Ps. cxxiv. 5]
	מגדל (MGDL): Towers, citadels
	מזל (MZL): The Influence from Kether
	עז (a'aZ): Strength; a he-goat

78
There are 78 cards in the Tarot. The Mystic Number of Kether as Hua. The sum of the Key-Numbers of the Supernal Beard.
	אומאל (AVMAL): Angel of 10 W.
	איואס (AYVAS): Angel of Ra Hoor Khuit
	היכל אהבה (HYKL AHBH): Briatic Palace of Chesed
	זמאל (ZMAL): Angel of ♂
	חלמ (ChLM): The breaker, dream
	חמל (ChML): To pity
	חנכ (ChNK): To initiate
	יזלאל (YZLAL): Angel of 2 S.
	כדמדי (KDMDY): Angel of 1st Dec. ♉
	לחמ (LChM): Bread (Ps. lxxviii. 25) = ChLM, by metathesis. [K.D. L.C.K. p. 500]
	מבהאל (MBHAL): Angel of 2 S.
	מזלא (MZLA): The Influence from Kether
	מלח (MLCh): Salt
	עזא (a'aZA): The name of a Giant

79

	בעז (Ba'aZ): Boaz, one of the Pillars of the Temple of Solomon
	גוע (GVa'a): Die
	ומבאל (VMBAL): Angel of 8 S.
	יאחינ (YAChYN): Jachin, one of the Pillars of the Temple of Solomon
	סיט (SYT): 3rd HB:Sh
	עדה (a'aDH): Conjunction, meeting, union

80

	ועד (Va'aD): Union; an assembling
	יה אדני (YH ADNY): God of Jesod-Malkuth of Briah
	יסוד (YSVD): Foundation
	כלל (KLL): Universal, general
	כס (KS): Throne. [Exod. xvii. 16]
	ממ (MM): 

81
= 4 Rt. 3 to the 4 power . ☽
	אלימ (ALYM): GODS
	אנכי (ANKY): I. [Ex. xxiii. 20]
	אפ (AP): Anger, wrath; also nose
	יילאל (YYLAL): Hearer of Cries; Angel of 6 P., and of 5 W.
	כאינ (KAYN): Night Demon of 2nd Dec. ♍
	כסא (KSA): Throne
	פא (PA): Here, hither

82

	אנאל (ANAL): Angel of ♀
	בעי (Ba'aY): A Prayer (Ch.)
	היכל גוגה (HYKL GVGH): Briatic Palace of Hod
	חסיד (ChSYD): Kindly, righteous, holy
	לבנ (LBN): Laban; white
	ניחוח (NYChVCh): The beloved thing; res grata

83

	אביע (ABYa'a): Abbreviatura quatuor systematum
	אגלי טל (AGLY TL): The drops of dew. [Job xxxviii. 28]
	בנייהו (BNYYHV): Benajahu, son of Jehoiada
	גימל (GYML): See 73
	גלימ (GLYM): A flowing, wave
	גפ (GP): Person, self; (Ch.) wing
	חנכה (ChNKH): Consecration; dedicated
	לכבאל (LKBAL): Angel of 2 P.
	זוע (ZVa'a): To flee, put one's things in safety. [Jerem. vi. 1]

84
7 x 12; or (2 to the 2nd power +3)x (2 to the 2ndpower x 3) --- hence esteemed by some
	אגפ (AGP): A wing (army), squadron; a chosen troop
	אהחע (AHCha'a): [I.Z.Q. 699]
	אחהע (AChHa'a): [Vide K.D. L.C.K. p.71]
	דממ (DMM): Was silent
	חלומ (ChLVM): A dream
	חנוכ (ChNVK): Enoch
	ידע (YDa'a): Knew

85

	בועז (BVa'aZ): Boaz (is referred to Hod)
	גביע (GBYa'a): A flower, cup
	הממ (HMM): Put in motion, routed
	מילה (MYLH): Circumcision
	פה (PH): The mouth; the letter HB:P

86

	אהיה אדני (AHYH ADNY): A name of GOD, asserting the identity of Kether and Malkuth
	אלהימ (ALHYM): Elohim. [Note masc. pl. of fem. sing.]
	הללויה (HLLVYH): Hallelu-Jah
	המולה (HMVLH): A rustling of wings
	הנאל (HNAL): Geomantic Intelligence of ♑
	יה יהוה אדמ (YH YHVH ADM): [Vide I.R.Q. 778]
	כוס (KVS): A cup; hence Pudendum Muliebre
	מומ (MVM): A blemish, spot, stain
	מיהאל (MYHAL): Angel of 10 C.
	מלוי (MLVY): Plenitude

87

	אלונ (ALVN): [Vide K.D. L.C.K. p. 114]
	אסוכ (ASVK): A cup
	בהלמי (BHLMY): Angel of 1st Dec. ♓
	גדפ (GDP): Blasphemed
	דגלימ (DGLYM): Standards, military ensigns
	זממ (ZMM): Determined
	חסידה (ChSYDH): White Storks
	לבנה (LBNH): Whiteness; frankincense; Sphere of ☽

88

	חכלל (ChKLL): Redness; sparkling
	חממ (ChMM): To be hot
	חסכ (ChSK): Darkness
	מגדיאל (MGDYAL): A duke of Edom
	נחל (NChL): Roaring, seething; burning

89

	גופ (GVP): Shut up
	גופ (GVP): Body
	דממה (DMMH): Silence
	מחיאל (MChYAL): Angel of 9 S.

90

	דוממ (DVMM): Very silent
	יכינ (YKYN): The Pillar, Jachin
	מימ (MYM): Water
	מלכ (MLK): Kings
	סל (SL): Wicker-basket
	פוד (PVD): Night Demon of 2nd Dec. ♌

91
The Mystic Number of Kether as Achad. The Number of Paths in the Supernal Beard; according to the number of the Letters, HB:K = 11, etc.
	אילנ (AYLN): A tree
	אמנ (AMN): Amen. [Cf. 741]
	אפוד (APVD): The Ephod
	יאהדונהי (YAHDVNHY): The "YHVH ADNY", interlaced
	כליאל (KLYAL): Angel of 4 S.
	כמאל (KMAL): Archangel of Geburah
	מאכל (MAKL): Food, fare
	מלאכ (MLAK): Angel
	מלכא (MLKA): Daughter, virgin, bride, Kore
	מנא (MNA): Manna
	סוכה (SVKH): A hut, tent
	פאהה (PAHH): Pekht, 'extension'

92

	אניאל (ANYAL): Angel of 5 S.
	בצ (BTz): Mud
	יהוה אלהיכ (YHVH ALHYK): (Deut. xxviii. 58.) [Vide no. 572]
	פחד (PChD): Terror, a name of Geburah

93

	אהליבמה (AHLYBMH): A duke of Edom. [Vide also Ezekiel xxiii.]
	בני אל (BNY AL): The sons of (the merciful) GOD
	לבונה (LBVNH): Incense
	מגנ (MGN): A disc, round shield
	נחלה (NChLH): Possession
	צבא (TzBA): Arduous, busy; an army

94

	גופה (GVPH): Corpse
	גיחזיונ (GYChZYVN): The valley of vision
	דעכ (Da'aK): To extinguish
	דפי (DPY): Destruction. [Ps. l. 20]
	חופ (ChVP): A shore
	חלונ (ChLVN): A window
	טפה (TPH): A drop
	ילדימ (YLDYM): Children

95

	אבנ גדלה (ABN GDLH): The great Stone
	דניאל (DNYAL): Angel of 2 W. --- Daniel
	ההעיה (HHa'aYH): Angel of 10 P.
	המימ (HMYM): The waters
	המנ (HMN): Multitude, abundance; Haman
	זבלונ (ZBLVN): Zabulon
	זחעי (ZCha'aY): Angel of 2nd Dec. ♌
	מאדימ (MADYM): ♂
	מהלכ (MHLK): Journey
	מלכה (MLKH): Queen
	סלה (SLH): Selah. [Ps. xxxii. 5, 6, etc.]

96

	אל אדני (AL ADNY): A name of GOD
	אלהינ (ALHYN): Chaldee form of ALHYM
	יוממ (YVMM): By day
	ללהאל (LLHAL): Praiseworthy; Angel of 7 W.
	מלאכה (MLAKH): Work
	סוד יהוה (SVD YHVH): The secret (counsel) of the Lord. [Ps. xxv. 14]

97

	אומנ (AVMN): Breeder, rearer; Day Demon of 1st Dec. ♊
	אמונ (AMVN): Changeless, constant; the GOD Amon
	בנ אדמ (BN ADM): The Son of Man
	האניאל (HANYAL): Archangel of Netzach
	זמנ (ZMN): The appointed time
	חטפ (ChTP): To seize suddenly (rapere)
	טפח (TPCh): A hand-breadth, palm. [I Kings vii. 26 --- Ex. xxv. 25]
	לבינה (LBYNH): A brick, tile
	מבנה (MBNH): A building; an architect
	מי אל הטב (MY AL HTB): Aquae EL Boni. ["Quicksilver," K.D. L.C.K. p. 442]

98

	הוא אלהימ (HVA ALHYM): A name of GOD
	זמנא (ZMNA): Temporary dwelling. [Ex. xxxiii. 11]
	חמנ (ChMN): Image; hid, concealed --- pertains to Sol and the Lingam-Yoni
	חסל (ChSL): To consume, eat
	צח (TzCh): White

99

	חבלי לידה (ChBLY LYDH): The pangs of childbirth
	חופה (ChVPH): The Vault of Heaven; an inner chamber; wedlock, nuptial
	טיטהיונ (TYTHYVN): Clay of Death, Infernal Abode of Geburah
	ידיעה (YDYa'aH): Cognition, knowledge

100

	ימימ (YMYM): A day; the seas; the times. [Vide no. 1100]
	כלימ (KLYM): Vases, vessels
	כפ (KP): The palm; the letter Kaph
	מדונ (MDVN): An effort, exertion. [I.R.Q. 995]
	מחי טבאל (MChY TBAL): Mitigation of the one by the other

101

	אלע (ALa'a): Swallowed, destroyed
	אסמ (ASM): A storehouse
	אק (AQ): [Vide K.D. L.C.K. p. 147]
	מומיה (MVMYH): Angel of 4 C.
	מיכאל (MYKAL): Archangel of ☉ and Fire; Angel of 7 S.; Angel of Malkuth of Briah, etc.
	מלוכה (MLVKH): Kingdom; a virgin princess; esp. THE Virgin Princess, i.e. Ecclesia
	נימא (NYMA): Gut; gut-string

102

	אווז לבנ (AVVZ LBN): A white goose
	אמונה (AMVNH): Trust, truth, faith
	בעל (Ba'aL): Bela, a King of Edom; to possess; lands, government
	נחמד (NChMD): Concupiscibilis
	צבי (TzBY): Grace, pride, fame, glory; a wild goat

103

	אבק (ABQ): Dust
	גננ (GNN): To guard, protect
	געל (Ga'aL): Loathed
	מזונ (MZVN): Food, meat (Ch.)
	מנחה (MNChH): Oblation
	נבאימ (NBAYM): Prophets
	עגל (a'aGL): A calf

104

	אב המונ (AB HMVN): Father of the mob, or of the multitude
	מדינ (MDYN): Quarrel, dispute
	סגולה (SGVLH): Personal (belongings), small private property
	סדמ (SDM): Sodom
	סולח (SVLCh): Giving up, presenting, remitting.
	צדי (TzDY): Trade; a fish-hook

105

	הפכ (HPK): To subvert, ruin, change
	ציה (TzYH): Desert land: Earth of Netzach

106

	דבק (DBQ): Attained
	מלהאל (MLHAL): Angel of 7 C.
	נונ (NVN): Fish; the letter Nun
	סאליה (SALYH): Angel of 9 C.
	פוכ (PVK): Stibium
	קו (QV): Line, string, linen thread

107

	ביצה (BYTzH): An egg
	וסיאל (VSYAL): Angel of Netzach of Briah
	עואל (a'aVAL): Angel ruling ♌

108
x 3 to the 3rd power : hence used as the number of beads of a rosary by some sects
	אזנימ (AZNYM): The ears
	באבי הנחל (BABY HNChL): The fruit of a deep valley
	גיהנמ (GYHNM): Hell of Jesod-Malkuth
	חיצ (ChYTz): A wall
	חמס (ChMS): To force, do wrong to
	חננ (ChNN): To love very much
	חסמ (ChSM): To shut up, obstruct
	חצי (ChTzY): The middle
	חק (ChQ): To measure out; a decree; tall. (Masc. gender.) Cf. 113
	סגהמ (SGHM): Angel L.T.D. of ♌
	עזאל (a'aZAL): A Giant: "the lust of GOD" {WEH NOTE: See also errata on 114}

109

	אסכוזדאי (ASKVZDAY): Day-demon of 2nd Dec. ♒
	בקז (BQZ): Lighting
	מנוחה (MNVChH): Quiet
	נגונ (NGVN): Music
	סחיאל (SChYAL): Angel of ♃
	עגול (a'aGVL): Circle, sphere
	צדידא (TzDYDA): 

110

	אב האמונה (AB HAMVNH): Father of Faith
	גג החופה (GG HChVPH): Tectum coeli fabrilis sub quo desponsationes coniugum fiunt
	דמיונ (DMYVN): Resemblance, likeness
	וטהצ (VTHTz): Cherubic Signs --- ♏ replaced by ♈
	חבק (ChBQ): To embrace
	ימינ (YMYN): At the end of the days; the right hand
	נס (NS): A sign, flag, standard
	סיטאל (SYTAL): Angel of 6 W.
	עמ (a'aM): Kinsman {WEH NOTE: see also errata on 114}

111
The Number of Abra-Melin Servitors of O.P.A.A. SUM (1 - (6 x 6))/6. ☉
	אדמוני (ADMVNY): Red. [Vide Gen. xxv. 25]
	אחד הוא אלהימ (AChD HVA ALHYM): A name of God
	אלפ (ALP): A thousand; Aleph
	אסנ (ASN): Ruin, destruction, sudden death
	אעמ (Aa'aM): AUM
	אפל (APL): Thick darkness
	יוד יהוה אדני (YVD YHVH ADNY): Passwords of ......
	מהולל (MHVLL): Mad
	נכיאל (NKYAL): Angel of ☉
	עולה (a'aVLH): Common holocaust; an ascent
	עלוה (a'aLVH): A Duke of Edom
	פלא (PLA): Title of Kether. (Mirum occultum)

112

	איעאל (AYa'aAL): Angel of 2 C.
	בנינ (BNYN): A structure; mode of building
	בנס (BNS): Was angry
	חדק (ChDQ): Sharpness
	יבק (YBQ): Jabok. [Gen. xxxii. 22.] Note 112 = 4 x 28
	יהוה אלהימ (YHVH ALHYM): The Lord GOD
	עיבל (a'aYBL): Ebal

113

	חקה (ChQH): Likewise; the same. (Fem. gender.) Cf. 108
	סליחה (SLYChH): A giving away, remitting
	פלג (PLG): A stream, brook

114

	גמליאל (GMLYAL): Qliphoth of Jesod
	דמע (DMa'a): Tear (weeping)
	חנונ (ChNVN): Gracious, obliging, indulgent
	מדע (MDa'a): Science
	[370] שוחונ (ShVChVN): Brains

115

	דמליאל (DMLYAL): Geomantic Intelligence of ♍
	הנני (HNNY): Here am I
	חומ היומ (ChVM HYVM): The heat of the day
	חזק (ChZQ): To make strong; vehement, eager

116

	יונימ (YVNYM): Doves
	מכונ (MKVN): Heaven of Chesed
	נדיבימ (NDYBYM): The munificent ones
	עילאה (a'aYLAH): Primordial

117

	אופל (AVPL): Fog, darkness
	אלופ (ALVP): Guide; Duke

118

	חלפ (ChLP): To pass, renew, change
	חמע (ChMa'a): To ferment
	חסנ (ChSN): Strength; Chassan, Ruler of Air
	כהנ גדול (KHN GDVL): The High Priest

119

	אבנ בוחנ (ABN BVChN): Lydian-stone
	בעלזבוב <> (Ba'aLZBVB <>): Beelzebub, the Fly-God
	דמעה (DMa'aH): Weeping (subst.)
	חאלפ (ChALP): Night Demon of 2nd Dec. ♈
	פגול (PGVL): Abominable

120
: 5 = SUM (1 - 15): --- HB:H being the 5th Path
	כעל (Ka'aL): Master
	מוסדי (MVSDY): Foundation, basis
	מועד (MVa'aD): The time of the decree
	מכינ (MKYN): Strengthening
	מלימ (MLYM): Prophetic sayings, or decrees: "His days shall be"; --- hence Abra-Melin
	מסכ (MSK): Velum
	סמכ (SMK): Prop; the letter Samekh
	ענ (a'aN): A name of GOD

121

	אלילימ (ALYLYM): Vain idols
	אמילמ (AMYLM): ?Termination of Abr-amelim?
	אפמ (APM): An end, extremity
	אצל (ATzL): Emanated from
	הגלגלימ (HGLGLYM): Of whirling motions
	חזוה די ליליא (ChZVH DY LYLYA): Nocturnal vision
	כעאל (Ka'aAL): Angel ruling ♋
	נמלא (NMLA): It is filled
	עכאל (a'aKAL): Angel L.T.N. of ♋

122

	אנוסה (ANVSH): Vi compressa
	גלגולימ (GLGVLYM): Revolutiones (Animarum)

123

	אהה יהוה אלהימ (AHH YHVH ALHYM): A name of GOD, implying Kether --- Chokmah --- Binah, 3,4, & 5 letters
	מלחמה (MLChMH): War
	נגע (NGa'a): A blow, plague
	ענג (a'aNG): Pleasure, delight
	פגמ (PGM): Laesio aliqualis, violatio

124

	חוסנ (ChVSN): An Oak; hardness
	עדנ (a'aDN): Pleasure, delight; Eden
	עיגיאל (a'aYGYAL): Qliphoth of Chokmah

125

	דנמאל (DNMAL): Night Demon of 2nd Dec. ♓
	כפכה (KPKH): [Vide S.D. v. 16]
	מנדאל (MNDAL): Angel of 4 P.

126

	אלמנה (ALMNH): A window
	אפילה (APYLH): Darkness
	גימיגינ (GYMYGYN): Day Demon of 1st Dec. ♉
	יהוה אדני אגלא (YHVH ADNY AGLA): A name of GOD
	מלונ (MLVN): Hospitality
	סוס (SVS): Horse
	עונ (a'aVN): On, a name of GOD [see 120] penalty of iniquity; "being taken away"

127

	מוטבע (MVTBa'a): Material
	פויאל (PVYAL): Angel of 5 P.

128

	אליפז (ALYPZ): Eliphaz
	אנמואל (ANMVAL): Angel ruling ♒
	חלצ (ChLTz): To deliver, loose
	חסינ (ChSYN): Robustus gratia [Vide K.D. L.C.K. p. 399]
	יהוה אלהינו (YHVH ALHYNV): GOD, the Eternal One

129

	עדנה (a'aDNH): Pleasure [Gen. xviii. 12]
	עונג (a'aVNG): Delight, pleasure

130

	הצלה (HTzLH): Deliverance
	מלאכ הגאל (MLAK HGAL): The Angel of redemption
	מלינ (MLYN): Decrees, prophetic sayings
	עינ (a'aYN): Eye; the letter Ayin
	עמודי (a'aMVDY): The Pillars
	עני (a'aNY): Destitute
	סלמ (SLM): A staircase, ladder
	פהליה (PHLYH): Angel of 5 C.

131

	אנפ (ANP): He was angry
	אפימ (APYM): Nose
	אפנ (APN): Turn, roll
	מכוסה (MKVSH): Title of Kether
	נלכאל (NLKAL): Angel of 6 C.
	סמאל (SMAL): Samael; Qliphoth of Hod
	ססיא (SSYA): Angel L.T.N. of ♍
	ענוה (a'aNVH): Humility

132

	בלק (BLQ): To make waste
	ננאאל (NNAAL): Angel of 4 W.
	קבל (QBL): To receive

133

	גיכק (GYKQ): [Vide I.Z.Q. 699]
	גפנ (GPN): Vine
	חעמיה (Cha'aMYH): Angel of 5 S.
	ימ המלח (YM HMLCh): The salt sea

134

	דלק (DLQ): Burning

135

	גוסיונ (GVSYVN): Day Demon of 2nd Dec. ♋
	מלכדיאל (MLKDYAL): Geomantic Intelligence of ♈
	עניה (a'aNYH): A destitute female
	קהל (QHL): The congregation. [Vide no. 161]
	קלה (QLH): [Vide K.D. L.C.K. p. 673]

136
♃
	הסמאל (HSMAL): Spirit of ♃
	יהפיאל (YHPYAL): Intelligence of ♃
	מלאכ הגואל (MLAK HGVAL): The Avenging Angel
	ממונ (MMVN): Fines, penalties
	קול (QVL): A voice

137

	אופנ (AVPN): A wheel
	אסטומכא (ASTVMKA): The belly, gullet. [?Hebrew: vide K. D. L.C.K. p. 138]
	מצבה (MTzBH): An image, a statue. [Gen. xxviii. 22]
	קבלה (QBLH): A receiving; the Qabalah

138

	בנ אלהימ (BN ALHYM): The Son of GOD
	חלק (ChLQ): To smoothe, divide
	חמצ (ChMTz): To leaven, ferment
	חנפ (ChNP): To pollute
	לבנונ (LBNVN): Libanon. [Cant. iv. 11, 15]
	מחצ (MChTz): He shall smite
	מצח (MTzCh): Forehead

139

	הדקל (HDQL): Hiddekel, the eastern river of Eden

140

	מלכימ (MLKYM): Kings; Angels of Tiphareth of Assiah, and of Netzach of Briah

141

	אמיצ (AMYTz): Robust; oaken
	אספ (ASP): Gathered, collected
	כוקיה (KVQYH): Angel of 4 P.
	מצוה (MTzVH): Precept
	נאמנ (NAMN): Trusty, steady
	פכיאל (PKYAL): L.A. Angel of ♋
	קמא (QMA): Prima

142

	אסמודאל (ASMVDAL): Geomantic Intelligence of ♉
	בליעל (BLYa'aL): Wickedness, destruction
	בלעמ (BLa'aM): A stranger; Balaam
	בעלמ (Ba'aLM): Night Demon of 3rd Dec. ♌
	מחמדימ (MChMDYM): Delights (Fire & Water)

143

	חליצה (ChLYTzH): The unshoeing
	נוזלימ (NVZLYM): Running waters. [Cant. iv. 15]

144

	סנדל (SNDL): A sandal
	קדמ (QDM): Anterius; the East; days first of the first

145
The numerical value of the 13 Paths of the Beard of Microprosophus
	מטה האלהימ (MTH HALHYM): The Staff of GOD. [Ex. xvii. 9]
	מעלה (Ma'aLH): Inscrutable
	נממיה (NMMYH): Angel of 6 P. <>
	סעודה (Sa'aVDH): A feast

146

	בבא קמא (BBA QMA): The First Gate. [Vide K.D. L.C.K. p. 184]
	סופ (SVP): Limit, end; boundless
	עולמ (a'aVLM): The world; an adult

147
The four Names in the Lesser Ritual of the Pentagram;
	יהוה אדני אהיה אגלא (YHVH ADNY AHYH AGLA): viz:

148

	אהיה יה יהוה אלהימ (AHYH YH YHVH ALHYM): A name of GOD
	בני אלהימ (BNY ALHYM): Angels of Hod in Assiah and Briah
	זולל וסובא (ZVLL VSVBA): Glutton and drunkard. [Deut. xxi. 20]
	חמק (ChMQ): To withdraw, retire
	מאזנימ (MAZNYM): Scales; ♎
	נצח (NTzCh): Victory
	קמח (QMCh): Flour, meal;

149

	אלימ חיימ (ALYM ChYYM): The living GODS. [Cf. 154]
	הספד (HSPD): A beating of the breast; a noisy striking

150

	ידעוני (YDa'aVNY): Ariolus. [K.D. L.C.K. p. 53]
	נעל (Na'aL): A walking shoe
	עינכ (a'aYNK): Thine eye. [Vide I.R.Q. 652]
	קנ (QN): Nest

151

	אלפ הה יוד הה (ALP HH YVD HH): AHYH spelt in full "TETRAGRAMMATON YHVH ALHYM YHVH AChD of the GODS is One TETRAGRAMMATON"
	מאלפ (MALP): Night Demon of 3rd Dec. ♈
	מקוה (MQVH): The Fountain of Living Waters. [Jer. xvii. 13]
	קומה (QVMH): A standing upright, stature
	קנא (QNA): Jealous

152

	בנימנ (BNYMN): Benjamin
	המוציא (HMVTzYA): The Bringing-forth One
	נציב (NTzYB): Residence, station

153

	חדקיאל (ChDQYAL): L.A. Angel of ♎

154

	אלהימ חיימ (ALHYM ChYYM): Elohim of Lives. [Cf. 149]

155

	אדני מלכ (ADNY MLK): Adonai the King
	דוד נאמנ (DVD NAMN): The faithful friend
	דקנא (DQNA): The beard (correct). [S.D. ii. 1, et seq.]
	ו:ט:נ:צ (V:T:N:Tz): Letters of the Cherubic signs
	יסיסיה (YSYSYH): Angel of 2nd Dec. ♑
	עלמיה (a'aLMYH): "The Concealed and Saving"; Angel of 6 W.
	קנה (QNH): A seed

156
12 x 13, the number of letters in each 'tablet of Enoch'
	אהל מועד (AHL MVa'aD): The Tabernacle of the congregation. [Lev. i. 1]
	אפעה (APa'aH): A viper
	באבאלענ (BABALa'aN): BABALON, THE VICTORIOUS QUEEN. [Vide XXX Aethyrs: Liber CDXVIII]
	הסניאל (HSNYAL): Angel of Hod of Briah
	יוספ (YVSP): Joseph [referred to Jesod]
	כמוצ (KMVTz): Angel of 1st Dec. ♏
	נעול (Na'aVL): 
	עופ (a'aVP): A bird
	פעו (Pa'aV): "Crying aloud"; the name of a King of Edom
	ציונ (TzYVN): Zion
	צלול (TzLVL): Limpid blood

157

	דמדומי חמה (DMDVMY ChMH): The setting of the ☉
	זעפ (Za'aP): Was angry, enraged; anger
	זקנ (ZQN): Lingam
	זקנ (ZQN): The beard. [Vide S.D. ii. 467, and no. 22]
	מופלא (MVPLA): Occult
	נקבה (NQBH): Female; Yoni
	ענואל (a'aNVAL): Angel of 9 S.
	קנז (QNZ): A Duke of Edom

158

	חיצימ (ChYTzYM): Arrows
	חנק (ChNQ): To suffocate
	מאזנינ (MAZNYN): Balances. [Ch.]

159

	בוצינא (BVTzYNA): Surpassing Whiteness. [Vide 934]
	נקדה (NQDH): Point

160
[Vide I.R.Q. 652]
	הקמיה (HQMYH): Angel of 3 S.
	כספ (KSP): Silver
	נפל (NPL): Fell down. Decidit
	סלע (SLa'a): A rock, stone
	עצ (a'aTz): A tree
	פיכנ (PYKN): A Duke of Edom
	פניכ (PNYK): Lay, fell. [Ez. iii. 8]
	צלמ (TzLM): Image
	קינ (QYN): Cain

161

	אדמ עילאה (ADM a'aYLAH): The heavenly man; lit. the 'primordial' or 'exalted' man
	קהל יהוה (QHL YHVH): The Congregation of the Eternal
	קינא (QYNA): 

162
Nine Paths of the Inferior Beard; 14 + 15 + ... + 22 =
	בנימינ (BNYMYN): Son of the right Hand; pr. n. of Benjamin
	גלאסלבול (GLASLBVL): Day Demon of 1st Dec. ♐
	סוסול (SVSVL): Angel ruling ♏

163

	הוא אלהימ אדני (HVA ALHYM ADNY): [Vide no. 361, a numerical Temurah of 163]
	נוקבה (NVQBH): Woman, wife

164

	דצע (DTza'a): 
	חדבקימ (ChDBQYM): Ye shall cleave
	חיצונ (ChYTzVN): Outer; civil, as opposed to sacred. [Vide K.D. L.C.K. p. 342]
	עמדימ (a'aMDYM): The Pillars

165

	חזקימ (ChZQYM): Strength. [Ez. iii. 8]
	להודיעמ (LHVDYa'aM): "To make them know." [Ps. xxv. 14]
	נעמה (Na'aMH): Nehema
	עממיה (a'aMMYH): NEMO. [Name of M.T.] Angel of 3 W.
	עצה (a'aTzH): An assembly

166

	בעלחנו (Ba'aLChNV): A King of Edom
	חייב ממונ (ChYYB MMVN): Reus mulctae. [Vide K.D. L.C.K. p. 498]
	מעונ (Ma'aVN): Heaven of Geburah
	נפול (NPVL): Night Demon of 3rd Dec. ♏
	עוצ (a'aVTz): Native land of Job
	עליונ (a'aLYVN): The Most High

167

	אסימונ (ASYMVN): The Unnameable One (a demon)
	זיקימ (ZYQYM): Fetters. [Job xxxvi. 8]

168

	אבא ואמא עילאה (ABA VAMA a'aYLAH): Parentes Superni

169

	טעמימ (Ta'aMYM): The accentuator

170

	מקל (MQL): The Wand; (David's) Staff
	עננ (a'aNN): Cloud

171

	מאציל (MATzYL): Principium emittens
	נאצל (NATzL): Emanating from
	פלאינ (PLAYN): Angel L.T.N. of ♒
	פניאל (PNYAL): "The Face of God"; name of an angel

172

	בקע (BQa'a): Cut, divided
	יעצב (Ya'aTzB): He affected. [Not written]
	ענבימ (a'aNBYM): Clusters; grapes
	עקב (a'aQB): The heel, the end. [Mic. vii. 20] Jacob

173

	גל עיני (GL a'aYNY): Lighten mine eyes
	גצפ (GTzP): Day Demon of 3rd Dec. ♒

174

	לפידימ (LPYDYM): Torches
	נוגה לו סביב (NVGH LV SBYB): Splendor ei per circuitum

175
SUM (1 - (7 x 7))/7) ♀
	יניקה (YNYQH): Suction
	מכפלה (MKPLH): Duplicity
	נפילה (NPYLH): A slipping, falling
	קדמאל (QDMAL): Spirit of ♀

176

	יועצ (YVa'aTz): An advisor, counselling
	לעולמ (La'aVLM): To eternity
	פסול (PSVL): Illegitimate

177

	אדונ האדונימ (ADVN HADVNYM): Dominus Dominorum
	גנ עדנ (GN a'aDN): The Garden of Eden
	זעק (Za'aQ): To cry out for help
	סגדלעי (SGDLa'aY): Angel L.T.D. of ♑
	מלוי המלוי (MLVY HMLVY): Plenitude of plenitudes

178

	חלצימ (ChLTzYM): The lower part, the loins
	חפצ (ChPTz): Good pleasure, choice, decision will
	כספ חי (KSP ChY): Quicksilver

179

	עקדה (a'aQDH): Ligatio

180

	מעיינ (Ma'aYYN): A spring, fountain. [Cant.; iv. 15]

181

	פסולה (PSVLH): Vicious, Faulty

182

	אל קנא (AL QNA): Deus Zelotes
	זעקה (Za'aQH): Outcry, clamour
	יעקב (Ya'aQB): Layer of snares, supplanter; Jacob
	מלאכ האלהימ (MLAK HALHYM): King of the Gods
	מקביל (MQBYL): Passive [as opposed to MChQBL = active]

183


184

	נקדל (NQDL): Ancient time; eastward

185


186

	אבנ נגפ (ABN NGP): A stone of stumbling; a rock to fall over. [Is. viii. 14]
	מוספ (MVSP): An increase
	ממונימ (MMVNYM): Praefecti
	מקומ (MQVM): A place
	קופ (QVP): Back of the Head; an ape; the letter Qoph

187

	אופנימ (AVPNYM): Angels of Chokmah, and of Chokmah of Briah
	זקפ (ZQP): Lifted up
	סופיאל (SVPYAL): [K. of S., Fig. 52]

188

	יעקוב (Ya'aQVB): Jaacob. [Vide K.D. L.C.K. p. 443.]
	כעל החוטמ (Ka'aL HChVTM): The Master of the Nose

189

	גל נעול (GL Na'aVL): Fons obseratus. [Cant. iv. 11]
	סבא דסבינ (SBA DSBYN): The Ancient among the ancient

190

	ויסע ויבא ויט (VYSa'a VYBA VYT): Ubi perrexit Angelus
	פנימי (PNYMY): Internal
	ציצ (TzYTz): Corona florida prominens
	צלע (TzLa'a): The side or flank; rib
	קמטיאל (QMTYAL): First devil. V. Porta Coelorum Fig. XVI
	קצ (QTz): The end, appointed time [Dan. xii. 13.] [Vide no. 305]

191

	אנפינ (ANPYN): Countenance
	אפסימ (APSYM): [Vide K.D. L.C.K. p. 143]
	פאכצ (PAKTz): Night Demon of 1st Dec. ♈
	קופה (QVPH): A box, chest; a repository

192

	זלעפה (ZLa'aPH): Poisonous wind, Simoon
	חדבקימ ביהוה (ChDBQYM BYHVH): Ye shall cleave in TETRAGRAMMATON. [Vide no. 220]

193


194

	צדק (TzDQ): Righteousness, equity, justice: the Sphere of ♃. [Vide K.D. L.C.K. p. 656]

195

	מקנה (MQNH): A flock
	פקודה (PQVDH): Visitation

196

	ימ סופ (YM SVP): Mare Soph. [Vide K.D. L.C.K. p. 435]
	קוצ (QVTz): The crown, summit, point

197

	אל עליונ (AL a'aLYVN): El Supernus
	אנא חטא עמ הזה (ANA ChTA a'aM HZH): [Vide K.D. L.C.K. p. 71]

198

	נצחימ (NTzChYM): Victories

199

	צדקה (TzDQH): A giving freely; 'Ελεημοσυνη

200

	כנפימ (KNPYM): Alae. [Vide K.D. L.C.K. p. 483]
	ענפ (a'aNP): A branch
	עצמ (a'aTzM): A bone
	קדמונ (QDMVN): Archetypal
	קיצ (QYTz): Belonging to the Spring
	קלע (QLa'a): A sling; a casting-net
	קסמ (QSM): Divination

201

	אר (AR): Light (Ch.)

202

	בקק (BQQ): To make empty
	בר (BR): Pure; a field; son
	זקיפה (ZQYPH): Elevatio
	נקבימ (NQBYM): Apertures
	סאיציאל (SAYTzYAL): L.A. Angel of ♏
	רב (RB): Many, much

203

	אבר (ABR): Initials of the Trinity: AB:BN:RVCh
	אבר (ABR): Passed away, perished; feather, wing; (it. membrum et quid genitale)
	ארב (ARB): To lie in wait
	באר (BAR): A well, spring
	ברא (BRA): Created
	גר (GR): Exotic, foreign

204

	אברא (ABRA): Commencement of the name Abra-Melin
	דר (DR): Foreign resident; race S.; an age (Ch.)
	צדיק (TzDYQ): The righteous

205

	אגאר (AGAR): Day Demon of 2nd Dec. ♈
	אדר (ADR): Splendrous
	גבר (GBR): Mighty; hero
	הר (HR): Mountain

206

	אדרא (ADRA): Assembly; area
	ברד (BRD): Hail
	דבר (DBR): Spake; word; cloud
	ימי עולמ (YMY a'aVLM): They of the World

207

	אגראב (AGRAB): ♏, a scorpion
	אדונ עולמ (ADVN a'aVLM): Lord of the Universe
	אור (AVR): Light. Cf. 9 and 11. Aur is the balanced Light of open day
	אינ סופ (AYN SVP): Limitless
	ברה (BRH): Ate
	גדר (GDR): Walled, fenced
	הבר (HBR): That which cuts. [Vide no. 607]
	זקנימ (ZQNYM): The Elders. [Deut. xxi. 19]
	זקק (ZQQ): Melt, fuse
	זר (ZR): The Crown of the Ark
	רבה (RBH): Grow great

208

	אברה (ABRH): Feather
	בור (BVR): A cistern
	גהר (GHR): Bowed
	גרה (GRH): To make strife, contend
	הגר (HGR): Hagar
	הרג (HRG): To kill
	זרא (ZRA): Abominable
	יצחק (YTzChQ): Jizchak. [Vide K.D. L.C.K. p. 266]
	רוב (RVB): Multitude

209

	אבראה (ABRAH): Chief Seer or Prophet (hence Abra-Melin)
	אגרה (AGRH): Reward, profit, prize
	אחר (AChR): To delay, tarry; behind (prep.)
	ארח (ARCh): Way
	בואר (BVAR): 10th Spirit of Goetia.
	בזר (BZR): Dispersed
	גור (GVR): Sojourned, dwelt
	הדר (HDR): Honour; a King of Edom; The Supernal Benignity
	זרב (ZRB): Oppressed

210

	אדהר (ADHR): Adam Primus. [Vide no. 607]
	בזאר (BZAR): Day Demon of 1st Dec. ♋
	בחר (BChR): Choice
	ברח (BRCh): Pass on, fly
	גזר (GZR): To decide, determine
	דור (DVR): To dwell; circle, cycle; generation
	הרה (HRH): To conceive
	חבר (ChBR): A joining of words; incantations; to conjoin; a brother
	חרב (ChRB): A sword
	מסנינ (MSNYN): Angel of 1st Dec. ♑
	נעמנ (Na'aMN): Naaman [Vide ΘΕΛΗΜΑ] N:a'a:Tz
	נקודימ (NQVDYM): Punctata

211

	אבחר (ABChR): [Worthy]
	ארי (ARY): A lion
	גבור (GBVR): Strong
	הארה (HARH): A flash; lightning
	חגר (ChGR): A girdle
	יאר (YAR): A flood; Jeor
	ירא (YRA): "Fear," the fear of the YHVH (i.e. wonderment)

212

	דבור (DBVR): Great Voice
	האור (HAVR): Night Demon of 1st Dec. ♑
	זהר (ZHR): Splendour; to enlighten
	זרה (ZRH): To spread out; harlot; golden
	חדר (ChDR): To enclose; secret chamber

213

	אביר (ABYR): Strong, powerful, mighty
	גיר (GYR): Calx
	הדדר (HDDR): [I.R.Q. 234 (?)]
	הרגה (HRGH): Slaughter
	וזר (VZR): Loaded
	זור (ZVR): To be strange; a stranger
	חסד עלאה דאל (ChSD a'aLAH DAL): The Supernal Mercy of GOD
	עננ גדול (a'aNN GDVL): Nubes Magna

214

	אזור (AZVR): A girdle
	זזר (ZZR): Angel of 1st Dec. ♈
	חור (ChVR): Whiteness
	ירד (YRD): Came down
	רוח (RVCh): Air; Spirit; wind; Mind

215

	אדיר (ADYR): Eminent; a Prince. [Ps. viii. I]
	אורח (AVRCh): A path, narrow way
	אחור (AChVR): Posterior; the reversed part
	זרח (ZRCh): A rising; to rise "as the ☉," give light
	חזר (ChZR): To encompass. [Vide K.D. L.C.K. p. 340]

216
3rd Rt.of
	אוראוב (AVRAVB): Night Demon of 1st Dec. ♎
	אריה (ARYH): Lion
	בבא מציעא (BBA MTzYa'aA): The middle Gate. [Vide K.D. L.C.K. p. 184]
	גבורה (GBVRH): Courage
	דביר (DBYR): Oracle
	דמ ענבימ (DM a'aNBYM): Blood of grapes
	יראה (YRAH): Dread, fear
	עומק (a'aVMQ): Profound. [Ps. xcii. 6]
	רוגז (RVGZ): Anger, wrath
	רוחב (RVChB): Latitude

217

	אויר (AVYR): The air
	בירה (BYRH): Temple, palace
	בריה (BRYH): Food
	דבורה (DBVRH): A bee
	טבור (TBVR): The navel
	מויעסאל (MVYa'aSAL): Angel ruling ♐
	סהקנב (SHQNB): Angel L.T.N. of ♏
	ריבה (RYBH): Controversia Domini

218

	אוירא (AVYRA): Ether. [Vide K.D. L.C.K. p. 55]
	בריאה (BRYAH): The Creative World
	חסד עולמ (ChSD a'aVLM): The benignity of Time
	ירח (YRCh): The ☽
	רבוי (RBVY): Multitude
	רזיא (RZYA): Arcana
	ריח (RYCh): Odour, a smell

219

	טהרה (THRH): Mundatio, mundities

220
The Number of Verses in Liber Legis
	בחיר (BChYR): The Elect
	גבירה (GBYRH): Heroina; Augusta; Domina
	חדבקימ ליהוה (ChDBQYM LYHVH): Ye shall cleave unto TETRAGRAMMATON. ["not" written]
	טהור (THVR): Clean, elegant
	נפילימ (NPYLYM): Giants. [Fully written only in Num. xiii. 33]

221
Left-handed Svastika, drawn on the square of ♂ given by Agrippa. Cf. 231
	ארכ (ARK): Long
	מנקאל (MNQAL): Angel of 10 S.

222

	אוריה (AVRYH): Urias
	אל המקומ (AL HMQVM): "Unto the Place." [Ex. xxiii. 20]
	הוורה (HVVRH): Whiteness
	הר טוב (HR TVB): Goodly mountain. [Ex. iii 25]
	כבר (KBR): Now, already; K'bar, "the river Khebar"; Day Demon of 3rd Dec.
	ראויה (RAVYH): I will chase

223


224

	דכר (DKR): Male (Ch.)
	דרכ (DRK): Walk, journey; The PATH
	חוקקי (ChVQQY): Principia emanandi
	חקוקי (ChQVQY): Effigurata
	יחור (YChVR): Union

225

	גזרדיא (GZRDYA): [Vide K.D. L.C.K. p. 234]

226

	צפונ (TzPVN): Profound, hidden; the North. [Vide K.D. L.C.K. p. 666]

227

	ארוכ (ARVK): Long, tall
	ברכה (BRKH): A piscine, pond; [Blessing, Prov. x. 22]
	זכר (ZKR): Remember; male (sacred Phallus --- Vide S.D. ii. p. 467)
	נזיקינ (NZYQYN): Damna. [Vide K.D. L.C.K. p. 569]

228

	בכור (BKVR): First-born
	ברוכ (BRVK): Blessed!
	כרוב (KRVB): Ruler of Earth
	עצ חיימ (a'aTz ChYYM): The Tree of Life

229


230

	הכרה (HKRH): Astonishment
	מקיפ (MQYP): [Vide K.D. L.C.K. p. 153]
	עקודימ (a'aQVDYM): Fasciata
	ראידיה (RAYDYH): Angel of 2nd Dec. ♍
	יגלפזק (YGLPZQ): Hod, 42-fold Name in Yetzirah. [Vide Liber 777, Col. xc. p. 18]

231
Right-handed Svastika, drawn on Sq. of ♂
	אריכ (ARYK): Prolonged; grew long
	דכורא (DKVRA): Male

232
Sum of the Four Ways of spelling TETRAGRAMMATON in the Four Worlds
	אמניציאל (AMNYTzYAL): Geomantic Intelligence of ♓
	אראל (ARAL): Ruler of Fire
	יה אויר (YH AVYR): Equivalent to YHY AVR, Fiat Lux. [Vide K.D. L.C.K. p. 55]
	יהי אור (YHY AVR): Let there be Light! The Mystic Name of Allan Bennett, a Brother of the Cross and Rose, who began this Dictionary.

233

	זכור (ZKVR): Memento
	עצ החיימ (a'aTz HChYYM): The Tree of Life. [Vide no. 228]

234

	דכאוראב (DKAVRAB): Night Demon of 3rd Dec. ♒

235

	צדקיאל (TzDQYAL): Archangel of Chesed, and Angel of Chesed of Briah

236

	ספעטאוי (SPa'aTAVY): Angel of L.T.N. of ♈
	קומצ (QVMTz): A handful

237

	ראהאל (RAHAL): Angel of 3 C.

238

	אדונ הנפלאוה (ADVN HNPLAVH): Dominus Mirabilium
	רחל (RChL): Rachel

239

	אזראל (AZRAL): Azrael, the Angel of Death
	ברזל (BRZL): Iron
	גורל (GVRL): The lot
	יכסגנוצ (YKSGNVTz): Angel of 3rd Dec. ♉

240

	מר (MR): Myrrh
	נגעי בני אדמ (NGa'aY BNY ADM): Plagae Filiorum Hominum. [I.e. Succubae, K.D. L.C.K. p. 562]
	נצנימ (NTzNYM): Prima Germina
	סספמ (SSPM): Angel of 1st Dec. ♒
	פקודימ (PQVDYM): Cash; counted out, paid down
	רמ (RM): High, lofty

241

	סמקיאל (SMQYAL): L.A. Angel of ♑

242

	אריאל (ARYAL): Ariel, Angel of Air
	זכירה (ZKYRH): Recollection

243

	אברמ (ABRM): Abram. [Vide 248]
	בראמ (BRAM): Created (he them). [Gen. v. 2.]
	גמר (GMR): Learned, complete. to finish, bring to pass (Ch.)
	גרמ (GRM): A bone; to destroy

244

	הרחאל (HRChAL): Angel of 7 P.
	רדמ (RDM): To be insensible; in deep sleep, in trance. [Vide no. 649]

245

	אדמ קדמונ (ADM QDMVN): Adam Qadmon
	מרה (MRH): Gall, bile
	רוח אל (RVCh AL): Spirit of God

246

	הריאל (HRYAL): Angel of 3 S.
	מור (MVR): Myrrh
	מראה (MRAH): Vision, aspect
	מרגג (MRGG): 
	הריאל (HRYAL): Angel L.T.D. of ♉
	רומ (RVM): Myrrh

247

	אלויר (ALVYR): Angel L.T.D. of ♑
	זרמ (ZRM): To overwhelm (Ps. lxxvii. 18); a flood
	מאור (MAVR): A light
	ראומ (RAVM): Night Demon of 1st Dec. ♉
	רמז (RMZ): Sensus symbolicus

248

	אברהמ (ABRHM): Abraham. [Vide 243 and 505, 510. Discussed at length in Zohar]
	אדמ+ברא (ADM+BRA): The Three that bear witness, above and beneath, respectively. HB:ADM the Spirit, the Water, and the Blood; HB:A being Air (Spiritus), HB:D standing for HB:DM Blood, and HB:M being both Water and the initial of HB:MYM, water. For HB:BRA see 203
	אוריאל (AVRYAL): Uriel or Auriel, archangel of Earth, and angel of Netzach; = "The light of God"
	במראה (BMRAH): In vision. [Vide K.D. L.C.K. p. 553]
	גמרה (GMRH): Gematria
	חמר (ChMR): Wine; bitumen; an ass (from "to disturb")
	רחמ (RChM): Mercy; womb
	רמח (RMCh): A lance

249

	ארזיאל (ARZYAL): L.A. Angel of ♉
	גמור (GMVR): Night Demon of 2nd Dec. ♎
	מגור (MGVR): Fear, terror

250

	אלחי העולמימ (ALChY Ha'aVLMYM): The living GOD of the Worlds; or, of the Ages
	דרומ (DRVM): [The South.] Midday
	מדור (MDVR): Habit, action (Ch.)

251

	ארנ (ARN): Fir, cedar
	וריהל (VRYHL): The angel Uriel: "Vrihl," i.e. Magical Force. [Vide Lytton's "Coming Race," and Abra-Melin --- forehead Lamen]
	רייאל (RYYAL): Angel of 10. W.

252

	מאורה (MAVRH): Serpent's den

253

	גרימ (GRYM): Proselytes
	מטרד (MTRD): Matred; who symbolizes the Elaborations on the side of Severity

254

	גרודיאל (GRVDYAL): Angel of 3rd Dec. ♒
	זוריאל (ZVRYAL): Geomantic Intelligence of ♎
	חמור (ChMVR): An ass
	מטרה (MTRH): A mark, aim
	נדר (NDR): A solemn promise, vow
	נרד (NRD): Spikenard. [Cant. iv. 14]
	רומח (RVMCh): A spear
	רחומ (RChVM): Merciful

255

	אנדר (ANDR): Night Demon of 3rd Dec. ♐
	חומרא (ChVMRA): Burdensome; with difficulty
	מזרח (MZRCh): The East
	נהר (NHR): A river, stream. [Gen. ii. 10]
	רנה (RNH): Cantatio elata

256
= 4th Rt 8th Rt. 4 to the 4th power = 2 to the 8th power = 256
	אהרנ (AHRN): Aaron
	אמירה (AMYRH): Tidings (Ps. lxviii. 12); a saying, speech. [Vide K.D. L.C.K. p. 128]
	בני צדק (BNY TzDQ): The Sons of the Righteous
	מפולמינ (MPVLMYN): [See no. 705] [Vide K.D. L.C.K. p. 20]
	רוח אמא (RVCh AMA): The Spirit of the Mother
	רוכל (RVKL): Aromatarius

257

	ארונ (ARVN): The Ark
	חרטמ (ChRTM): A Magician
	ליראיו (LYRAYV): "To His fearers." [Ps. xxv. 14]
	מקל לבנה (MQL LBNH): The White Wand
	נורא (NVRA): Terribilis Ipsa

258

	אור אדומ (AVR ADVM): The red light
	חירמ (ChYRM): Hiram (King of Tyre)
	רחמי (RChMY): Mercy

259

	גרונ (GRVN): Throat
	נטר (NTR): Nitre
	ראובנ (RAVBN): Reuben

260
SUM (1 - (8 x 8))/8. ☿
	טיריאל (TYRYAL): Intelligence of ☿
	טמירא (TMYRA): The Concealed
	י:נ:ר: (Y:N:R:): I.N.R. [Vide 270]
	ירימ (YRYM): Exaltabitur
	כרמ (KRM): A vineyard
	לפסילימ (LPSYLYM): Ineptos et profanos
	מה אדיר (MH ADYR): [Ps. viii. 1]
	סר (SR): Declined
	צמצמ (TzMTzM): To gather, draw together

261

	אסר (ASR): He bound; an obligation, a prohibition
	דראונ (DRAVN): Abhorrence, abomination. [Is. lxvi. 24]

262

	אהרונ (AHRVN): Lofty; Aaron
	גבוראנ (GBVRAN): Severities
	הנורא (HNVRA): Terrible
	חדרימ (ChDRYM): Conclavia
	עינ בעינ (a'aYN Ba'aYN): Eye to eye. [I.R.Q. 645]

263

	אבדרונ (ABDRVN): Angel of 2nd Dec. ♒
	אורונ (AVRVN): Angel of 2nd Dec. ♓
	ברכיאל (BRKYAL): Geomantic Intelligence of ♏
	גמטריא (GMTRYA): Gematria
	גרס (GRS): Pained

264

	חקוקימ (ChQVQYM): Emanantia. [Vide K.D. L.C.K. p. 338]
	ירדנ (YRDN): Jarden. [Vide K.D. L.C.K. p. 455]
	מדרכ (MDRK): Footprints (foot's breadth). [Deut. ii. 5]
	סדר (SDR): A straight row. [Vide K.D. L.C.K. p. 455]
	רהטימ (RHTYM): Channels, pipes

265
::6
	אדריכל (ADRYKL): Architect
	הרס (HRS): Broke down
	צעקה (Tza'aQH): A cry of the heart; anguish, anxiety

266

	חברונ (ChBRVN): Chebron
	ירונ (YRVN): Termination of Qliphoth of 12 Signs
	צמצומ (TzMTzVM): Contraction

267

	אסור (ASVR): Illicit, forbidden
	ורכיאל (VRKYAL): Geomantic Intelligence of ♌
	מרכבה (MRKBH): Currus; Vehiculum; Thronus
	נזיר (NZYR): Nasiraeus

268

	אבני הקלע (ABNY HQLa'a): Stones of the sling

269

	ארחינ (ARChYN): By-ways
	בנ רוח אב (BN RVCh AB): Father --- Spirit --- Son
	כרוביאל (KRVBYAL): Angel of Binah of Briah

270

	י:נ:ר:י: (Y:N:R:Y:): I.N.R.I. Initials of: Jesus Nazaraeus Rex Judaeorum; Igni Natura Renovata Integra; Intra Nobis Regnum deI; Isis Naturae Regina Ineffabilis; and many other sentences. Vide Crowley Coll. Works Vol. I. Appendix

271

	ארע (ARa'a): Earth (Ch.); whence = low, mean
	והרינ (VHRYN): Angel of 2nd Dec. ♐
	לאמר (LAMR): [Vide no. 256, AMYRH]

272

	ארעא (ARa'aA): Earth
	בער (Ba'aR): To consume, injure; brutish
	מכה רבה (MKH RBH): Percussione magna
	ערב (a'aRB): The evening: an 'Arab,' i.e. a person living in the West
	רינוו (RYNVV): Day Demon of 3rd Dec. ♐

273

	אבנ מאסו הבונימ (ABN MASV HBVNYM): The stone which the builders rejected [Ps. cxviii. 22]
	אור גנוז (AVR GNVZ): The Hidden Light
	ארבע (ARBa'a): Four
	גער (Ga'aR): Rebuked
	גרע (GRa'a): Took away

274

	דרכימ (DRKYM): Paths

275

	אחוריימ (AChVRYYM): [Vide K.D. L.C.K. p. 72]
	דירה נאה (DYRH NAH): Domicilium pulchrum. [Vide K.D. L.C.K. p. 395]
	יאר דינ (YAR DYN): Fluvius Indicii. [Vide K.D. L.C.K. p. 117]
	סרטו (SRTV): Qy. Struti "scripture"

276

	[278] אחובראינ (AChVBRAYN): Angel L.T.N. of ♎. [Vide Liber 777, p. 29]
	כנור (KNVR): A Cithara
	כרוכל (KRVKL): Night Demon of 1st Dec. ♌
	סיהרא (SYHRA): The ☽

277

	זרע (ZRa'a): To sow, propagate; seed, semen
	למרבה (LMRBH): [For multiplying.] ["Not" written. Vide K.D. L.C.K. pp. 157 and 837]
	סהיבר (SHYBR): Angel of 3rd Dec. ♌
	רעוא (Ra'aVA): Gratia, benevolentia

278

	כרובימ (KRVBYM): Angels of Jesod, and of Binah of Briah --- Cherubim
	עובר (a'aVBR): Passing over
	עולמ המוטבע (a'aVLM HMVTBa'a): The Material World

279

	סגירו (SGYRV): Leprosy. [Vide K.D. L.C.K. p. 495]

280
[7 x 40, the Squares of the walls of the Vault. See Equinox I. 3. p. 222]
	דגדגירונ (DGDGYRVN): Qliphoth of ♑
	דכרונ (DKRVN): A record (Ch.)
	יער (Ya'aR): Angel of the Wood of the World of Assiah
	כ:מ:נ:פ:צ: (K:M:N:P:Tz:): The Letters of Judgment: the 5 letters having a final form
	סנדלפונ (SNDLPVN): Archangel of Malkuth
	עיר (a'aYR): Citizenship
	פר (PR): [Vide S.D. 528]
	רפ (RP): Terror

281

	אפר (APR): A crown --- Ashes
	פאר (PAR): Attire; adorned

282

	אראלימ (ARALYM): Angels of Briah, and of Malkuth of Briah
	רוח חיימ (RVCh ChYYM): Spirit of Lives

283

	זהב סגור (ZHB SGVR): Aurum inclusum
	זכרונ (ZKRVN): Memoriale. [Vide no. 964]
	רגלימ (RGLYM): That goes on foot

284

	אמבריאל (AMBRYAL): Geomantic Intelligence of ♊
	ערוגה (a'aRVGH): The small area of an enclosed garden

285


286

	מרומ (MRVM): High, lofty

287

	אפיקומנ (APYQVMN): Pars Azymorum
	ופאר (VPAR): Night Demon of 3rd Dec. ♉
	זעיר (Za'aYR): Little
	מוריאל (MVRYAL): Geomantic Intelligence of ♋

288

	ביעור (BYa'aVR): Vindication
	זאפר (ZAPR): Day Demon of 1st Dec. ♍
	עיבור (a'aYBVR): Breeding, bearing; offspring. [Vide K.D. L.C.K. p. 313]
	רפח (RPCh): [Vide K.D. L.C.K. p. 571]

289

	פטר (PTR): Apertio. [Vide no. 537]
	פרט (PRT): Particulare

290

	ערכ    <> (a'aRK    <>): Thine enemy

291

	אפיקי מימ (APYQY MYM): Torrentes Aquarum
	אצר (ATzR): (He) treasured
	ארצ (ARTz): Earth: in particular, the Earth of Malkuth
	נמרא (NMRA): Qy. spotted?
	סירכא (SYRKA): Adhaesio; adhaerens; princeps
	צכמקיאל (TzKMQYAL): L.A. Angel of ♒

292

	אפרוה (APRVH): A young bird. [Deut. xxii. 6]
	בצר (BTzR): Gold
	רפואה (RPVAH): A medicine, drug

293

	צארב (TzARB): Day Demon of 2nd Dec. ♉

294

	ארגמנ (ARGMN): Purple
	חורפ (ChVRP): Pertaining to Autumn
	מלכיצדק (MLKYTzDQ): Melchizedec. [Gen. xiv. 18]

295

	יריעה (YRYa'aH): Curtain, canopy; vault. [Ps. civ. 2]
	כנפי העינ (KNPY Ha'aYN): Eyelids
	פטור (PTVR): [Vide K.D. L.C.K. p. 498]

296

	הארצ (HARTz): Of the Earth. [Vide no. 992]
	כורע (KVRa'a): Incurvens se
	צור (TzVR): Rigorose procedere; fumarie; rock. [Vide K.D. L.C.K. pp. 459, 663]

297

	אוצר (AVTzR): Thesaurus; gazophylacium; conservatorium
	אלהימ גבור (ALHYM GBVR): A name of GOD attributed to Geburah
	ארמונ (ARMVN): A secured house; a fortified castle
	בצרה (BTzRH): A City of Edom
	כורסיא (KVRSYA): The Throne; a Name of Briah
	נוריאל (NVRYAL): Nuriel
	צואר (TzVAR): The neck

298

	אמנ אור (AMN AVR): Amen, our Light
	בר אלהינ (BR ALHYN): Son of the GODS
	צחר (TzChR): White
	רחמימ (RChMYM): Pathetic appeals; commiserations

299

	רהדצ (RHDTz): Angel of 2nd Dec. ♋

300

	אור בפאהה (AVR BPAHH): Khabs am Pekht
	אלפ למד הי יוד ממ (ALP LMD HY YVD MM): Vide Beth Elohim. Dissert. II. Cap. I. A spelling of ALHYM in full.
	יצר (YTzR): Formation
	מעמקימ (Ma'aMQYM): Profundities
	מצפצ (MTzPTz): God of Chesed, and of Hod of Briah; "Temura" of YHVH
	ערל (a'aRL): Incircumcisus
	פירוד (PYRVD): Separation
	רוח אלהימ (RVCh ALHYM): The Spirit of GOD. [Vide Gen. i. 3]

301

	אדני המלכ נאמנ (ADNY HMLK NAMN): "My Lord, the faithful King"; a name of GOD
	אש (ASh): Fire
	מנורה (MNVRH): A candlestick

302

	ארקא (ARQA): Earth of Hod
	בקר (BQR): To cut open, inquire into; Dawn
	סראיאל (SRAYAL): L.A. Angel of ♊
	קבר (QBR): Hath protected
	רקב (RQB): To putrefy

303

	באש (BASh): Did evil; putrefaction

304

	חרוצ (ChRVTz): A species of gold
	דש (DSh): Green
	כאמבריאל (KAMBRYAL): Geomantic Intelligence of ♒
	קדר (QDR): White

305

	אור צח (AVR TzCh): Dazzling white light
	דשא (DShA): Tender herb. [Gen. i. 11]
	הקממנע (HQMMNa'a): Netzach, 42-fold Name in Yetzirah. [Vide Liber 777, col. xc.]
	יצרה (YTzRH): Yetzirah; "formation"
	כריעה (KRYa'aH): A curving, bending
	קצ הימינ (QTz HYMYN): The end of days, appointed time. [Dan. xii. 13]
	שה (ShH): A lamb
	הש (HSh): 

306

	אב הרחמימ (AB HRChMYM): Father of Mercy
	אב הרחמנ (AB HRChMN): Merciful Father
	אשה (AShH): A woman, wife; virago
	דבש (DBSh): Honey
	מטרונא (MTRVNA): Domina. [Vide K.D. L.C.K. p. 528]
	ניצוצינ (NYTzVTzYN): [Vide K.D. L.C.K. p. 571]
	קור (QVR): Coldness; pertaining to Winter
	רהעאל (RHa'aAL): Angel of 6 S.
	רימונ (RYMVN): Malo-Granatum

307

	וריאצ (VRYATz): Night Demon of 2nd Dec. ♏
	רבקה (RBQH): Ribkah

308

	בוקר (BVQR): Daybreak
	זרקא (ZRQA): Sparsor
	חקר (ChQR): Investigation
	חרק (ChRQ): A harsh, grating sound
	קרוב (QRVB): Approaching, near
	קרח (QRCh): Ice

309

	מוסגר (MVSGR): A leper. [Vide K.D. L.C.K. p. 495]
	מנחראי (MNChRAY): Angel of 2nd Dec. ♉
	שאגה (ShAGH): Strepitus cordis, mussitatio, susurratio, rugitus
	שדה (ShDH): Field, soil, land

310

	דוש (DVSh): To trample on, conquer
	חבש (ChBSh): To govern, bind
	ייצר (YYTzR): Formed. [I.R.G. 227]
	י:ר:ק: (Y:R:Q:): The initials of Idra Rabba Qadisha. [Each letter is half of each Letter of KThR, Kether]
	יש (YSh): Is, are; essence, being
	כפיר (KPYR): ♌ iuvenis
	מדורינ (MDVRYN): Habitations

311

	איש (AYSh): Man; but vide K.D. L.C.K. p. 83
	עריאל (a'aRYAL): Angel of 9 C.
	צפקיאל (TzPQYAL): Archangel of Binah
	רפאל (RPAL): Archangel of Air; Angel of ☿, and of Chokmah of Briah, etc.
	שבט (ShBT): Rod. [Ps. xxiii. 4]

312
26 x 12, the Twelve Banners
	ושו (VShV): Night Demon of 3rd Dec. ♎
	חדש (ChDSh): To renew; hence = a new moon, a month
	מערב (Ma'aRB): West. [Cf. 272]

313

	אננאורה (ANNAVRH): Angel of 1st Dec. ♍

314

	הלל גמור (HLL GMVR): [Vide K.D. L.C.K. p. 275]
	מטטרונ (MTTRVN): Metatron, Archangel of Kether, and Angel of Tiphareth of Briah. [When spelt with HB:Y after HB:M it denotes Shekinah]
	רחוק (RChVQ): Out of the way, remote
	שדי (ShDY): Shaddai: "The Almighty"; a name of GOD

315

	גביש (GBYSh): Ice; crystal
	ושט (VShT): Gullet
	יצירה (YTzYRH): Formation
	מראה הנוגה (MRAH HNVGH): Visio Splendoris
	עמרה (a'aMRH): Gomorrah

316
The Number of Servitors of Abra-Melin Sub-Princes
	ושאגו (VShAGV): Day Demon of 3rd Dec. ♈
	חבוש (ChBVSh): Ligatus
	ירוק (YRVQ): Green
	ישו (YShV): JESU
	עומר (a'aVMR): A bundle, handful
	פוקד עונ (PVQD a'aVN): Visitans iniquitatem
	קוטרא (QVTRA): Aporrhea
	שאיה (ShAYH): [Vide K.D. L.C.K. p. 54]
	שחח (ShChCh): To worship, bow down

317

	ואלפר (VALPR): Day Demon of 3rd Dec. ♉
	זרעמ (ZRa'aM): [Vide Ps. xcvii. 11]
	יבשה (YBShH): Arida
	פרזל (PRZL): Iron (Ch.)
	שיבה (ShYBH): Hoariness

318

	כיור וכנו (KYVR VKNV): Labrum lavacri, et basio eius
	שיח (ShYCh): A copse, bush

319


320

	נער (Na'aR): "Boy," Name of Enoch, and of Metatron
	עירמ (a'aYRM): A Duke of Edom. [Vide Liber 777, p. 22]
	רעימ (Ra'aYM): The friends
	סריטיאל (SRYTYAL): L.A. Angel of ♐

321

	אלינכיר (ALYNKYR): Angel of 3rd Dec. ♋
	לסלרא (LSLRA): Angel L.T.D. of ♍
	שאהיה (ShAHYH): Angel of 9 W.
	אדימירונ (ADYMYRVN): Qliphoth of ♉

322

	כבש (KBSh): Lamb
	לברמימ (LBRMYM): Angel L.T.N. of ♐
	קו האמצעי (QV HAMTza'aY): Linea media

323

	אח רחוק (ACh RChVQ): Long-absent brother
	בהימירונ (BHYMYRVN): Qliphoth of ♒
	סטנדר (STNDR): Angel of 3rd Dec. ♈

324

	מיטטרונ (MYTTRVN): See no. 314; it denotes Shekinah

325
♂
	ברצבאל (BRTzBAL): Spirit of ♂
	גראפיאל (GRAPYAL): Intelligence of ♂
	נינדוהר (NYNDVHR): Angel of 2nd Dec. ♏
	צריכה (TzRYKH): Need, indigence

326

	יהשוה (YHShVH): Jesus. [Note the letters of TETRAGRAMMATON completed by HB:Sh 300 q.v. the Spirit of GOD]
	שאייה (ShAYYH): Vision

327

	בוטיש (BVTYSh): Day Demon of 2nd Dec. ♍
	ישיבה (YShYBH): [Vide K.D. L.C.K. p. 461]
	כיצאור (KYTzAVR): Night Demon of 3rd Dec. ♑

328
4 Princes + 8 Sub-Princes + 316 servient to Spirits
	החשיה (HChShYH): Angel of 3 W.
	חשכ (ChShK): To steam; darkness. [Vide K.D. L.C.K. p. 280]

329

	טרסני (TRSNY): Angel of 1st Dec. ♎

330

	מצר (MTzR): Boundary, terminus; crosspath
	סער (Sa'aR): Revolution; hurricane, tempest
	של (ShL): Error: fault

331

	אפרימ (APRYM): Ephraim
	אשל (AShL): Arbor magna. [Gen. xxi. 33]
	רציאל (RTzYAL): Archangel of Chokmah

332

	אור היקוד (AVR HYQVD): Lux Ardoris
	אנדרומאל (ANDRVMAL): Night Demon of 3rd Dec. ♓
	מבצר (MBTzR): A Duke of Edom. [Vide Liber 777, p. 22]
	מקומ פנוי (MQVM PNVY): Locus vacuus. [Vide K.D. L.C.K. p. 551]

333

	איק בכר (AYQ BKR): Qabalah of the Nine Chambers
	חורונזונ (ChVRVNZVN): Choronzon. [Vide Dr. Dee, & Lib. 418, 10th Aire]
	שלג (ShLG): Snow

334

	קול דממה דקה (QVL DMMH DQH): A still, small Voice. [I Kings, xix. 12]

335

	ימי רעה (YMY Ra'aH): Dies Mali
	מלכ מלכי המלכימ (MLK MLKY HMLKYM): The KING above the King of Kings. [Vide K.D. L.C.K. p. 537]
	מערכה (Ma'aRKH): Ordering, desposition

336

	שאלה (ShALH): An attack; a request, petition
	שבכיד (ShBKYD): Night Demon of 1st Dec. ♊

337

	פורלאכ (PVRLAK): Ruler of Earth
	שאול (ShAVL): Hell of Supernals; a City of Edom; the Place of Askings. [Vide Liber 777, p. 23]

338

	חלש (ChLSh): To cast down
	יכבוש (YKBVSh): He hath pardoned (or, subjected)
	לבוש (LBVSh): A garment; clothing
	שלח (ShLCh): To send forth

339


340

	יסגדיברודיאל (YSGDYBRVDYAL): Angel of 3rd Dec. ♐
	ליש (LYSh): "Ferocious" lion
	מגרופיא (MGRVPYA): Uncus focarius --- fire- shovel
	ספר (SPR): Book
	פרס (PRS): Pares; a word written on the wall at Belshazzar's feast. [Vide Dan. v. 28]
	שמ (ShM): There; The Name

341
The sum of the 3 Mother Letters; HB:A, HB:M, and HB:Sh
	אמש (AMSh): Yesterday
	אשמ (AShM): Guilty, damned
	פרה אדומה (PRH ADVMH): A red cow
	פרסא (PRSA): Expansum; sepimentum; diaphragma
	שמא (ShMA): The Name (Ch.)

342

	בישל (BYShL): Coctio
	בשמ (BShM): Perfume
	פוכלור (PVKLVR): Night Demon of 2nd Dec. ♉
	שלהבה (ShLHBH): A blaze, flame

343
3 Rt.
	ויאמר אלהימ (VYAMR ALHYM): "And GOD said." [Gen. i. 3]
	זפרונ (ZPRVN): A sweet smell

344

	פרדס (PRDS): A plantation, garden [Cant. iv. 13]

345

	אלהימ אחרימ (ALHYM AChRYM): Di Alieni
	אל שדי (AL ShDY): GOD Almighty
	בשגמ (BShGM): "In that also" --- referred to Daath
	השמ (HShM): "The" NAME
	לישה (LYShH): Lioness. [Vide K.D. L.C.K. p. 501]
	מהש (MHSh): 5th HB:Sh
	משה (MShH): Moses. [See 543, numerical Temurah of 345]
	שולט (ShVLT): Dominator
	שילה (ShYLH): Shiloh
	שככה (ShKKH): He was appeased. [Esther, vii. 10]

346

	מקור (MQVR): A spring; spring water
	צנור (TzNVR): A water-pipe; channel
	רצונ (RTzVN): Good pleasure; the Will-power

347

	אפריונ (APRYVN): Palanquin (Cant. iii. 9); Bridal bed; nuptial chariot. ["thalamus seu coelum fabrile sub quo copulantur nubentes"]

348

	חמש (ChMSh): Five; to set in array
	חשמ (ChShM): Third King of Edom

349


350

	אליגוש (ALYGVSh): Day Demon of 3rd Dec. ♌
	ספיר (SPYR): A sapphire (Ex. xxviii. 18). [Vide K.D. L.C.K. p. 19]
	עפר (a'aPR): Ophir; a young mule; dust of the Earth
	קרנ (QRN): The Horn; head
	ריקמ (RYQM): Vacuum
	שכל (ShKL): Intellectus

351

	אנש (ANSh): Man
	אשימ (AShYM): Angels of Malkuth; burnt or incense offering; "The flames"
	חירמ אביפ (ChYRM ABYP): Hiram-Abif, a cunning artificer at the Temple of Solomon; the hero of a famous allegory prophetical of FRATER PERDURABO
	לוסנהר (LVSNHR): ♄ in ♌. Angel ruling 1st Dec. ♌, that was rising at the birth of FRATER PERDURABO
	מושה (MVShH): Moses the Initiator
	נשא (NShA): Elevatus

352

	אור מעלה (AVR Ma'aLH): The Exalted Light
	ארכ אפימ (ARK APYM): Long of Nose; i.e. Merciful; a title of the supreme GOD
	ברקימ (BRQYM): Lightning
	קרבנ (QRBN): An approach

353

	גשנ (GShN): Goshen
	חמשה (ChMShH): The fifth
	סוד יהוה ליראיו (SVD YHVH LYRAYV): The Secret of TETRAGRAMMATON is to His fearers. [Ps. xxv. 14]
	שמחה (ShMChH): Delight, joy

354

	דשנ (DShN): Grew fat; anointed
	שמטה (ShMTH): Heptaeteris intermissoria

355

	מחשבה (MChShBH): Thought; idea
	שנה (ShNH): Year

356

	ארזי לבנונ (ARZY LBNVN): The Cedars of Lebanon
	כפורימ (KPVRYM): Expiationes. [Vide K.D. L.C.K. p. 612]
	עופר (a'aVPR): A young mule
	עורפ (a'aVRP): Ophra, mother of Goliath
	רוחינ דחיינ (RVChYN DChYYN): Spirits of the living

357

	כגד יכש (KGD YKSh): 42-fold Name, Geburah in Yetzirah
	נושא (NVShA): Iniquity

358

	גשנה (GShNH): Shame
	יבא שילה (YBA ShYLH): Shiloh shall come
	משיח (MShYCh): "Messiach," the Messiah
	נחש (NChSh): Nechesh, the Serpent that initiated Eve
	אשיאומ (AShYAVM): (Taking the three HB:H's in AHYHVH as concealing the Mothers, we get GR:Iota. GR:Alpha. GR:Omega. &)

359

	סטריפ (STRYP): Angel of 3rd Dec. ♓
	שטימ (ShTYM): The Sacred Wind
	שטנ (ShTN): Satan. [Vide K.D. L.C.K. p. 235]

360

	המשיה (HMShYH): The Messiah
	הנשה (HNShH): [Vide K.D. L.C.K. p. 235]
	השנה (HShNH): [Vide K.D. L.C.K. p. 235]
	ישימ (YShYM): Angels of Jesod of Binah
	מהשיה (MHShYH): Seeking safety; Angel of 7 W.
	רעמימ (Ra'aMYM): Tonitrus
	שינ (ShYN): "Shin"; a tooth
	שני (ShNY): Two

361
* 3 * * * * 6 * * * 1 * *
	אדני הארצ (ADNY HARTz): God of Malkuth
	אנשי (ANShY): "Men"; "impurities"
	אשינ (AShYN): Foundations. [Ch.]
	הר ציונ (HR TzYVN): The Mountain Zion
	כשיאל (KShYAL): Ruler of ♄
	מצראל (MTzRAL): Angel of 7 P.

362


363

	שדי אל חי (ShDY AL ChY): The Almighty and Ever-living GOD

364

	אור מופלא (AVR MVPLA): Lux Occulta
	השטנ (HShTN): Satan
	שדינ (ShDYN): Demons
	שטנה (ShTNH): Opposition; resistance

365

	נשיה (NShYH): Earth of Tiphareth
	פריעה (PRYa'aH): An uncovering, exposing

366

	אנדראלפ (ANDRALP): Night Demon of 2nd Dec. ♑

367

	אישונ (AYShVN): Black [scil. of eye-pupil]: middle: homunculus
	פאיכורנ (PAYKVRN): Day Demon of 3rd Dec. ♊

368

	רוח אלהימ חיימ (RVCh ALHYM ChYYM): The Spirit of the GODS of the Living

369
SUM (1 - (9 x 9))/9. ☽
	חשמודאי (ChShMVDAY): Spirit of ☽. [Vide Liber 777, p. 19]
	עולמ הבריאה (a'aVLM HBRYAH): The World of Briah
	שהדני (ShHDNY): Angel of 2nd Dec. ♊

370

	עקר (a'aQR): A foundation, basis
	עש (a'aSh): Creation
	ערבי נחל (a'aRBY NChL): Salices rivi. [Lev. xxiii. 40]
	צפר (TzPR): Zopher
	קסטרא (QSTRA): White lead, tin
	קרע (QRa'a): To rend, cut, blame, curse
	רעננ (Ra'aNN): Green. [Vide S.D. p. 104]
	שלמ (ShLM): Salem

371

	שמאל (ShMAL): Sinistrum

372

	אספירכא (ASPYRKA): Aqua spherica
	כבשימ (KBShYM): Agni
	כבשנ (KBShN): An oven, furnace
	עקרב (a'aQRB): ♏
	עשב (a'aShB): Herbage, grass
	שבע (ShBa'a): Seven

373


374


375

	כלל ופרט (KLL VPRT): Generally and specially
	שלמה (ShLMH): Solomon
	שמלה (ShMLH): A City of Edom

376

	מושל (MVShL): Dominator
	עשו (a'aShV): Esau, father of the men of Edom. (Ad-om, Adlantes<>)
	צפור (TzPVR): A bird
	שלומ (ShLVM): Peace. [Refers to Kether]

377

	גיד הנשה (GYD HNShH): Nervus Luxatus; Vena Ischiatica. [Gen. xxxii. 32]
	שבעה (ShBa'aH): Seven

378

	בשלומ (BShLVM): 'In peace'
	חשמל (ChShML): Pruna ignita; Chaschmal
	שבוע (ShBVa'a): Iuramentum. [K.D. L.C.K. p. 695]

379

	אבשלומ (ABShLVM): Abschalom

380
[The sum of the letters of TETRAGRAMMATON multiplied severally by those of Adonai; (HB:Y x HB:H) + (HB:N x HB:V) + (HB:D x HB:H) + (HB:A x HB:Y)] = Y:K:Sh:N
	[397] יהבמצרימ (YHBMTzRYM): Difficulty, narrowness
	עצב עצבונ (a'aTzB a'aTzBVN): Pain, trouble, misery
	ערפל (a'aRPL): Thick darkness, fog
	קסטירא (QSTYRA): Vide no. 370]
	רקיע (RQYa'a): Heaven of Hod

381

	שועה (ShVa'aH): Clamour, prayer

382

	צאראצ (TzARATz): Day Demon of 3rd Dec. ♎

383

	שבועה (ShBVa'aH): Iuramentum. [Vide K.D. L.C.K. pp. 67, 695]

384


385

	מהרנצ (MHRNTz): Angel of 2nd Dec. ♎
	עשיה (a'aShYH): Assiah, the World of Matter
	שכינה (ShKYNH): Gloria cohabitans [vide K.D. L.C.K. p. 711]; the Glory of God
	שפה (ShPH): Lip

386

	ישוע (YShVa'a): Jesus
	לשונ (LShVN): Tongues
	צירופ (TzYRVP): Tziruph, a table of Temurah

387


388

	חלמיש (ChLMYSh): The hardest rock. [Ps. cxiv. 8]
	חפש (ChPSh): To search out diligently
	שלחנ (ShLChN): Table; bread

389


390

	זכר ונקבה (ZKR VNQBH): Gen. v. 2.
	מפרע (MPRa'a): Retrorsum
	פרנס (PRNS): Alens, pascens
	שמימ (ShMYM): Heaven
	שמנ (ShMN): Oil
	שצ (ShTz): Night Demon of 2nd Dec. ♊

391

	ישועה (YShVa'aH): Salvation, help
	רומ מעלה (RVM Ma'aLH): The Inscrutable Height. [Kether]

392

	בשמימ (BShMYM): Aromata
	משבנ (MShBN): Habitaculum

393


394

	שולחנ (ShVLChN): Table. [Vide no. 388]

395

	אביר יעקב (ABYR Ya'aQB): Robustus (virilitas) Iacob
	השמימ (HShMYM): The Heavens
	השמנ (HShMN): Oil
	מנשה (MNShH): Manasseh
	משנה (MShNH): Second
	שופט (ShVPT): Judge

396

	יפוש (YPVSh): Day Demon of 1st Dec. ♏

397

	אור פנימי (AVR PNYMY): Lux Interna. (Title of Kether)

398

	חמשימ (ChMShYM): Fifty
	חפשי (ChPShY): Book
	סטרעטנ (STRa'aTN): Angel L.T.D. of ♈
	שחצ (ShChTz): Pride; esp. of gait

399

	שגופי (ShGVPY): 

400

	כשפ (KShP): To use Magic, witchcraft
	משכיל (MShKYL): Erudiens, a title of Yesod
	פשוטה (PShVTH): Sensus literalis. [Vide K.D. L.C.K. p. 12]
	קרנימ (QRNYM): (He had) Karnaim (in his hand)
	שיככימ (ShYKKYM): Angels of Chesed of Briah
	שק (ShQ): Sack

401

	ארר (ARR): Cursing
	את (ATh): Essence; "the"

402

	בקש (BQSh): Sought into, or after
	ברר (BRR): Tested, purified
	בת (BTh): Filia
	עכביש (a'aKBYSh): A spider
	שבילינ (ShBYLYN): Paths

403

	אבנ ספיר (ABN SPYR): The Stone; Sapphire

404

	דת (DTh): Law, edict
	שקד (ShQD): Almond; to watch, be awake; to hasten

405

	זחלי עפר (ZChLY a'aPR): Fearful things, serpents of the dust. [Job]
	שפכה (ShPKH): [Cf. no. 227, HB:ZKR.] Phallus; urethra. [Vide Deut. xxiii. 2]

406

	אתה (AThH): THOU: a name of GOD
	עמ הארצ (a'aM HARTz): Vulgar, common; plebeian
	שוק (ShVQ): Leg
	שנוימ (ShNVYM): Alterations
	תו (ThV): The letter Tau

407

	אות (AVTh): Signum
	שמנ טוב (ShMN TVB): The Precious Oil

408

	אבנ הספיר (ABN HSPYR): Lapis sapphirinus
	זאת (ZATh): Haec
	חשק (ChShQ): [Vide Deut. x. 10, 15]

409

	אבהתא (ABHThA): Patriarchs
	אבות (ABVTh): Fathers
	אחת (AChTh): One (fem.)
	הקדש (HQDSh): Ha-Qadesh; Holy Ones

410

	דרור (DRVR): Liberty; a swallow
	הרהר (HRHR): Visions, imaginations. [Dan. iv. 2]
	מצרפ (MTzRP): Metzareph
	משכנ (MShKN): The Tabernacle
	קדוש (QDVSh): Sacred; Saint
	קודש (QVDSh): Holy
	שמע (ShMa'a): He heareth
	שקי (ShQY): Hod, 42-fold Name in Yetzirah

411

	אלישע (ALYSha'a): Elisha
	היכל רצונ (HYKL RTzVN): Briatic Palace of Tiphareth
	מוסדי ארצ (MVSDY ARTz): Fundamenta Terrae
	משכנא (MShKNA): Habitaculum
	סדר זמנימ (SDR ZMNYM): Ordo temporum
	תהו (ThHV): Desolation, emptiness. (Expresses first root of all good)

412

	בית (BYTh): The letter Beth
	חדת (ChDTh): New. (Ch.)
	יהשוה אלהימ (YHShVH ALHYM): Jesus GOD
	צמר לבנ (TzMR LBN): White whorl
	רומ עליונ (RVM a'aLYVN): Celsitudo superna
	תאוה (ThAVH): A longing for

413


414

	אזות (AZVTh): Azoth, "the" fluid. A + Z (Lat.) + Omega (Grk.) + Th (Heb.). Initial and final in 3 tongues
	אינ סופ אור (AYN SVP AVR): The Limitless Light
	הגות (HGVTh): Meditation. [Ps. xlv. 4]
	משוטטימ (MShVTTYM): Going forth. [Vide no. 770]

415

	אבראה דבר (ABRAH DBR): The Voice of the Chief Seer
	אחות (AChVTh): Sister
	הקדוש (HQDVSh): The Holy One; Sodomite
	מעשה (Ma'aShH): Work
	עשליה (a'aShLYH): Angel of 10 C.

416

	הרהור (HRHVR): Thought, meditation
	משכונ (MShKVN): A pledge

417

	זית (ZYTh): Olive
	תיבה (ThYBH): Arca. (Noah's Ark)

418
(Note 4 + 1 + 8 = 13)
	בולשכינ (BVLShKYN): Boleskine
	חטאת (ChTATh): Peccatum. (Est femina Lilith impia)
	חית (ChYTh): Kheth, a fence
	נוצר חסד (NVTzR ChSD): Servans misericordiam
	מאכאשאנה (MAKAShANH): "The Word of the Aeon." [Vide Liber 418] HB:A B R A H A D A B R A 418 = ChYTh = BYTh HA, the House of He: because of I.Z.Q. 694; for HB:H formeth HB:K, but HB:Ch formeth YVD: each = 20. Thus is Abrahadabra a Key of the Pentagram. Also, by Aiq Bkr, it = 22: and 418 = 19 x 22. 19 = Manifestation; it therefore manifests the 22 Keys of R.O.T.A. The first meaning is ABRAH DBR, = The Voice of the Chief Seer. It resolves into Pentagram and Hexagram as follows: 1st "method." A R/ \B A A Pentagram A forms 12 and 406, ChVA D H B\ /R A and AThH [406 = ThV], where AThH = Microprosopus, and HVA = Macro- prosopus. The Arcanum is therefore that of the Great Work 2nd "method." B A R H A Pentagram A Hexagram Here BHR = 207 A A B D R = AYN SVP AVR, etc. and DBR = Voice ("The Vision and the Voice"); thus showing, by Yetziratic attribution, the Three Wands --- Caduceus: Phoenix: Lotus. Note always ABR are the three Supernals. 3rd "method." A A B A A Pentagram A Hexagram give 205 + 213; R B H D R both mean "Mighty," whence Abrahadabra is "The Word of Double Power." AAB show AB: AIMA: BN, viz., Amoun : Thoth : Mout. By Yetziratic Method, H:D:R: are Isis : Horus : Osiris. (Also, for H:D:R:, vide I.R.Q. 992.) Dividing as 3 and 8, we get GR:Delta of Horus dominating the Stooping Dragon, ARR YAV: also --- A from R/_\B we get A---B A---H | | | | A---D R---A 8 = DD, Love, and 207 = AVR, Light; 8 x 207 = 18, which is equivalent to ChY, living; further, 297 = 23 x 9 = ChYH, Life: hence, Licht : Liebe : Leben. Again, 418 = ATh + YAV, = 21 + 397, q.v. DBR and 678 = 6 + 7 + 8 = 21. 2 x HB:B + 2 x HB:R + HB:D = 32. The Five different letters represent Amoun : Thoth : Isis : Horus : Osiris. they (A + B + R + H + D) add to 212 (q.v.). Finally, HB:A is the Crown, HB:B the Wand, HB:D the Cup, HB:H the Sword, HB:R the R.C. See Equinox, V and VII, for further details.

419

	טית (TITh): Serpent: the letter Teth
	סדמ + עמרה (SDM + a'aMRH): Sodom and Gomorrah

420

	היתה (HYThH): It was
	חבית (ChBYTh): Dolium, vas
	עשנ (a'aShN): Vapour, smoke
	שלמימ (ShLMYM): Pacifica
	רצפימ (RTzPYM): 

421

	כשויעיה (KShVYa'aYH): Angel ruling ♑
	פשיאל (PShYAL): Angel ruling ♓

422

	אריכ אנפינ (ARYK ANPYN): The Vast Countenance
	קו ירוק (QV YRVQ): Linea Flava (quae circumdat Mundum)

423

	לווי העמורימ (LVVY Ha'aMVRYM): [Ex. xxvii. 10, 11.] [Vide K.D. L.C.K. p. 420]

424

	טוטת (TVTTh): Angel L.T.N. of ♉

425

	הגזית (HGZYTh): [Vide no. 1175]
	נעשה (Na'aShH): [Vide K.D. L.C.K. p. 208
	שמיעה (ShMYa'aH): Auditus

426

	מושיע (MVShYa'a): Servator; salvator
	תוכ (ThVK): Medium

427


428

	געשכלה (Ga'aShKLH): The Breakers-in-pieces; the Qliphoth of Chesed
	חשמלימ (ChShMLYM): The Brilliant Ones; Angels of Chesed, and of Tiphareth of Briah
	נשבעו (NShBa'aV): Iuraverunt

429

	זור אריה (ZVR ARYH): A lion's whelp. [Gen. xl. 9]
	משפט (MShPT): Judgment, equity
	שגעונ (ShGa'aVN): 

430

	נפש (NPSh): Nephesch, the animal soul of Man
	נשפ (NShP): Covered with mist; darkness, twilight
	פרקימ (PRQYM): Membra
	צדיק יסוד עולמ (TzDYQ YSVD a'aVLM): Full Title of Ninth Sephirah. "The Righteous is the Foundation of the world"
	שפנ (ShPN): Concealed
	תהו ובהו (ThHV VBHV): Tohu v-Bohu; see Gen. 1.
	תל (ThL): Dew

431

	נוטריקונ (NVTRYQVN): Notariqon

432

	צללי ערב (TzLLY a'aRB): Eventide shadows
	תבל (ThBL): Earth of Jesod

433

	בלאת (BLATh): Day Demon of 1st Dec. ♌
	זכות (ZKVTh): Merit

434

	איש מלחמה (AYSh MLChMH): The Lord of War. [Ex. xv. 3]
	דלת (DLTh): The letter Daleth; door

435

	התל (HThL): Deceived
	משפטו (MShPTV): [Vide K.D. L.C.K. p. 156]

436

	אפטרופס (APTRVPS): Tutor, curator; prafectus; administrator
	ביתחוי (BYThChVY): Angel L.T.D. of ♏
	הושענה (HVSha'aNH): Hoschanah
	שטנ עז (ShTN a'aZ): "Σατανᾶς" [Vide K.D. L.C.K. p. 505]
	שעטנז (Sha'aTNZ): [Vide K.D. L.C.K. p. 505 723 & 701, nos. 9, 10; also at ShBYRH]

437

	אפרסמונ (APRSMVN): Balm; the balsam tree

438

	אבנ שלימה (ABN ShLYMH): The whole (perfect) stone. [Deut. xxvii. 6]

439

	גלות (GLVTh): Exilium
	עוגרמענ (a'aVGRMa'aN): Angel L.T.N. of ♊

440

	תהלה (ThHLH): Collaudatio. [Vide K.D. L.C.K. pp. 90, 729]
	תלי (ThLY): The Great Dragon; means "curls." [I.R.Q. 834; vide 510]
	תמ (ThM): Irreproachable; perfect

441

	אילת (AYLTh): Cerva
	אמת (AMTh): Truth; Temurah of ADM, by Aiq Bekar
	גחלת (GChLTh): A live coal
	לריאר (LRYAR): Day Demon of 2nd Dec. ♌
	רמרא (RMRA): Angel L.T.D. of ♓

442

	אפסי ארצ (APSY ARTz): Termini Terrae

443

	בתולה (BThVLH): A virgin; a city. ♍
	גלית (GLYTh): Goliath

444

	מקדש (MQDSh): The Sanctuary
	דמשק (DMShQ): Damascus

445
The total value of the Single Letters; HB:H,HB:V,HB:Z,HB:Ch,HB:T,HB:Y,HB:L, HB:N,HB:S,HB:a'a,HB:Tz, and HB:Q

446
Number of Stars in the Northern hemisphere
	מות (MVTh): Destruction; death
	פישונ (PYShVN): Pison
	קרסולימ (QRSVLYM): Tali pedum

447

	דמר רבא (DMR RBA): Initials of the Three Above and the Three Beneath. [Vide 248]

448

	במות (BMVTh): Excelsa

449

	אור מצוחצח (AVR MTzVChTzCh): Lux fulgentissima
	טלית (TLYTh): Cloak

450

	לוחות (LVChVTh): Tabulae
	מדות (MDVTh): [Vide K.D. L.C.K. p. 508]
	פרי עצ (PRY a'aTz): The Fruit of the Tree
	פשע (PSha'a): Transgression
	רצונ באינ גבול (RTzVN BAYN GBVL): Beneplacitum termino carens; Arbitrum illimitatum
	שוכנ עד (ShVKN a'aD): Inhabitans Aeternitatem
	שעלימ (Sha'aLYM): Craftiness, cunning
	תנ (ThN): The Dragon

451

	את האדמ (ATh HADM): The Essence of Man
	מיתא (MYThA): Mortis
	שנאנימ (ShNANYM): Angels of Tiphareth
	תהומ (ThHVM): The Abyss

452

	חמדת (ChMDTh): [Vide no. 552]
	קרקבנ (QRQBN): The crop; the Maw

453

	בהמות (BHMVTh): Behemoth
	נפש חיה (NPSh ChYH): The Animal Soul, in its fullness; i.e. including the Creative Entity or Ego, Chiah

454

	חותמ (ChVThM): Sigillum
	קדשימ (QDShYM): The "Holy Ones"; Consecrated catamites kept by the Priesthood

455


456

	אימתה (AYMThH): Formido maxima
	הר המור (HR HMVR): The Mountain of Myrrh. [Cant. iv. 6]
	כותל (KVThL): Paries
	שוקימ (ShVQYM): Crura
	תאנה (ThANH): The Fig-tree and fruit

457

	זתימ (ZThYM): Olives

458

	חתנ (ChThN): A covenant; an engagement; a betrothed
	שחקימ (ShChQYM): Contusores; cloudy heavens; Heaven of Netzach

459


460

	טנתא (TNThA): [Vide K.D. L.C.K. p. 371]
	צללד מירונ (TzLLD MYRVN): Qliphoth of ♊
	קדש ליהוה (QDSh LYHVH): "Holy unto TETRAGRAMMATON." [Ex. xxxix. 30]

461

	אדנות (ADNVTh): [Vide K.D. L.C.K. p. 539]
	איתנ (AYThN): Robustus, validus, asper, horridus, rigidus

462

	ארצ עליונה (ARTz a'aLYVNH): Terra Superna (est Binah)
	ניתב (NYThB): A path
	עומק רומ (a'aVMQ RVM): Profundum Celsitudinis

463

	באתינ (BAThYN): Day Demon of 3rd Dec. ♍
	גסת (GSTh): Pillar of Mildness --- paths, HB:G, HB:S, and HB:Th
	זכוכית (ZKVKYTh): Crystal, glass
	מטה השקד (MTH HShQD): A rod of almond
	תבונה (ThBVNH): The Special Intelligence. [I.Z.Q. 264, et seq.]
	תגינ (ThGYN): Caps, crowns, diadems
	תחנה (ThChNH): Precatio

464


465

	נשיקה (NShYQH): A kiss; a little (or, sweet) mouth

466

	גלגלת (GLGLTh): Skull
	כליות (KLYVTh): Renes
	עולמ היצירה (a'aVLM HYTzYRH): The World of Formation
	שמעונ (ShMa'aVN): Simeon

467

	גלגלתא (GLGLThA): [Vide S.D. 33]

468

	ביתונ (BYThVN): Angel of 3rd Dec. ♊

469

	חשוקיהמ (ChShVQYHM): Trabeationes ligaturae illarum

470

	דור דורימ (DVR DVRYM): Eternity. (Literally, a cycle of cycles)
	נתהיה (NThHYH): Angel of 8 S.
	עמר נקי (a'aMR NQY): Pure Wool
	עת (a'aTh): Period of time; Time
	קרקע (QRQa'a): Solum; fundus

471

	היכלות (HYKLVTh): Palatia
	המוריה הר (HMVRYH HR): Mount Moriah. [2 Chron. iii. 1]

472

	בעת (Ba'aTh): Was terrified

473

	אתהואני (AThHVANY): The Three Persons. [ATH: HVA: ANI coalesced]
	גולגלתא (GVLGLThA): Skull
	טחנות (TChNVTh): Molitrices

474

	דעת (Da'aTh): Knowledge. [Vide K.D. L.C.K. p. 252, et seq.]
	חכמות (ChKMVTh): (Plural) --- Wisdom
	עדת (a'aDTh): The Testimony within the Ark
	עתד (a'aThD): A ram, he-goat; a prepared sacrifice
	רעדר (Ra'aDR): Angel L.T.D. of ♋

475

	בגולגלתא (BGVLGLThA): [Vide no. 473.] In Golgotha

476

	בית דינ (BYTh DYN): Domus Iudicii; Curia; Consistorium iudiciale

477


478

	גולגולת (GVLGVLTh): Cranium, calvaria
	זעיר אנפינ (Za'aYR ANPYN): The Lesser Countenance, Microprosopus
	כתובימ (KThVBYM): Hagiographa

479

	טוחנות (TVChNVTh): Molentes

480

	אבני תוהו (ABNY ThVHV): Lapides inanitatis
	דעות (Da'aVTh): [Vide K.D. L.C.K. p. 252]
	לילית (LYLYTh): lilith, Qliphoth of Malkuth
	עדות (a'aDVTh): [Vide K.D. L.C.K. p. 252]
	עית (a'aYTh): Malkuth, 42-fold Name in Yetzirah

481

	בעוגת (Ba'aVGTh): 
	גבעות (GBa'aVTh): Hills
	חייב מיתא (ChYYB MYThA): Reus mortis
	טבעת (TBa'aTh): Annulus

482

	אספקלריא (ASPQLRYA): A looking-glass, mirror

483

	נושא עונ (NVShA a'aVN): Ferens iniquitatem

484


485

	בת גלימ (BTh GLYM): Filia scaturiginum. [Is. x. 30, "Daughter of Gallim"]
	התלימ (HThLYM): Mockeries [Job xvii. 2. Vide 435]

486

	יהוה בחכפה ימד ארצ (YHVH BChKPH YMD ARTz): A name of GOD
	יסודות (YSVDVTh): Foundations
	מצה פרוסה (MTzH PRVSH): Azymum fractum
	עוית (a'aVYTh): A King of Edom
	נהתאל (NHThAL): Angel of 8 P.

487


488

	פתח (PThCh): Ianua, ostium
	תאומיאל (ThAVMYAL): Qliphoth of Kether
	תעבודו (Tha'aBVDV): Ye shall worship

489

	משלמ גמול (MShLM GMVL): Retribuens; rependens retributionem

490

	מתנ (MThN): The giving. [Vide no. 1106]
	סלת (SLTh): Fine flour, meal
	תמימ (ThMYM): Perfect
	תצ (ThTz): Binah, 42-fold Name in Yetzirah

491

	אמנת (AMNTh): Nutrix
	ניתאל (NYThAL): Angel of 4 W.

492


493

	את יהוה אלהיכ (ATh YHVH ALHYK): The Name given in Deut. xxviii. 58; without ATh = 92, q.v.

494

	כובע הישועה (KVBa'a HYShVa'aH): Galea salutis
	תפוח (ThPVCh): An apple

495

	דמות אדמ (DMVTh ADM): Similtudo hominis
	מתנה (MThNH): Gift

496

	לויתנ (LVYThN): Leviathan
	מלכות (MLKVTh): Malkuth
	צרור (TzRVR): A small bundle

497

	אומנת (AVMNTh): Nutrix
	תאומימ (ThAVMYM): ♊; ♊

498

	היכל זכות (HYKL ZKVTh): Briatic Palace of Geburah

499

	אילת אהבימ (AYLTh AHBYM): Cerva amorum. [Prov. v. 19, "a loving hind"]
	צבאות (TzBAVTh): Busy, arduous; an army; 'hosts'

500

	כתפ (KThP): The humerus
	מכתמ (MKThM): Kimelium aureaum
	שר (ShR): Princeps
	תימנ (ThYMN): A Duke of Edom

501

	אשר (AShR): Asher; blessedness
	אתנימ (AThNYM): Fortis; fortia, robusta
	ראש (RASh): The head
	שאר (ShAR): Flesh; Night Demon of 1st Dec. ♓
	שכינה עילאה (ShKYNH a'aYLAH): Sehechinah Superior
	תמונה (ThMVNH): Likeness, similitude

502

	בשר (BShR): To tell glad tidings; flesh, body
	בתק (BThQ): To cut

503
HB:G (_) HB:R O The Cup of the Stolistes HB:Sh /_\
	גרש (GRSh): Expelled, cast forth

504

	דרש (DRSh): Sought for

505

	שרה (ShRH): Sarah; Principissa. [Vide 510 & cf. 243 & 248]

506

	אבגיתצ (ABGYThTz): 
	כפות (KPVTh): [Vide no. 1196]
	שור (ShVR): Bovis a sinistra; an ox; ♉. [Vide K.D. L.C.K. p. 99] --- ♉

507

	שאור (ShAVR): That which causes ferment; yeast

508

	שחר (ShChR): Daybreak; black

509

	גשור (GShVR): Bridge

510

	דרוש (DRVSh): Sensus allegoricus. [Vide K.D. L.C.K. p. 12]
	ישר (YShR): Rectitudo, aequitas recta; rectilineum
	ריש (RYSh): The head
	שיר (ShYR): Song
	שרי (ShRY): Sarai. [Vide 505]
	תנינ (ThNYN): Draco; see 440

511

	עתיאל (a'aThYAL): 
	רישא (RYShA): "The" HEAD
	שורה (ShVRH): [Vide K.D. L.C.K. p. 463]

512
= 9th Rt. 2 to the 9th power
	דבקות (DBQVTh): Adhaesio, cohaesio
	שחדר (ShChDR): Angel of 3rd Dec. ♎

513


514

	חקות (ChQVTh): [Vide K.D. L.C.K. p. 213]

515

	נחלה בלי מצרימ (NChLH BLY MTzRYM): Possessio sine angustiis
	שוטר (ShVTR): Minister iudicii
	תפלה (ThPLH): Phylacterium

516

	אשירה (AShYRH): Lucus. [Vide K.D. L.C.K. p. 168]
	פרצופינ (PRTzVPYN): Personae

517

	ארימירונ (ARYMYRVN): Qliphoth of ♉. [Vide no. 321, & Liber 777]
	מתנה טובה (MThNH TVBH): The good gift, i.e. Malkuth
	פלאות (PLAVTh): Occultae. [Vide 417]
	שבירה (ShBYRH): Confractio. [Vide K.D. L.C.K. p. 698, et seq.]

518


519

	ברבטוש (BRBTVSh): Day Demon of 2nd Dec. ♊

520

	דמעות (DMa'aVTh): Tears
	כשר (KShR): Legitium

521

	אש יורד (ASh YVRD): Ignis descendens
	ושריה (VShRYH): Angel of 2 P.
	מחשופ הלבנ (MChShVP HLBN): Nudatio candoris

522


523


524


525

	יהוה צבאות (YHVH TzBAVTh): The LORD of Hosts, a name of GOD referred to Netzach

526

	משקופ (MShQVP): Superliminare

527


528


529

	ציקי קדירה (TzYQY QDYRH): Affatura ollaris cum iusculo dulci
	שיטרי (ShYTRY): Day Demon of 3rd Dec.♋

530

	חבצלת (ChBTzLTh): The Rose
	קלת (QLTh): Voices
	תקל (ThQL): Tekel, a word of the 'writing on the wall' at Belshazzar's fabled feast

531


532


533

	טבל וילונ שמימ (TBL VYLVN ShMYM): Heaven of Jesod of Malkuth
	מלכ בלהות (MLK BLHVTh): King of Terrors

534

	קלדשק (QLDShQ): A certain Name of GOD

535


536

	טלית לבנה (TLYTh LBNH): A white cloak
	מסלות (MSLVTh): Sphere of the fixed stars
	עולמ העשיה (a'aVLM Ha'aShYH): The World of Assiah, the 'material' world

537

	אצילות (ATzYLVTh): Emanatio; Atziluth, the Archetypal world
	חוט השדרה (ChVT HShDRH): Medulla spinalis
	פטר רחמ (PTR RChM): Apertio uteri

538

	בת קול (BTh QVL): Daughter of the Voice. --- Echo. [The Bath Qol is a particular and very sacred method of divination]

539


540

	מתנימ (MThNYM): Lumbi; the upper part

541

	ישראל (YShRAL): Israel

542


543

	אהיה אשר אהיה (AHYH AShR AHYH): "Existence is Existence," the NAME of the Highest GOD

544

	תפוחימ (ThPVChYM): Apples. [Cant. ii. 5]

545

	חזיר מיער (ChZYR MYa'aR): Aper de Sylva

546

	מתוק (MThVQ): Sweet
	שומר (ShVMR): P's; a watchman
	שמור (ShMVR): Custodi
	שרהיאל (ShRHYAL): L.A. Angel of ♈

547


548

	בעירירונ (Ba'aYRYRVN): Qliphoth of ♈
	הצגנת (HTzGNTh): Night Demon of 3rd Dec. ♋
	יהוה אלוה ודעת (YHVH ALVH VDa'aTh): A Name of GOD, referred to Tiphareth
	עבירירונ (a'aBYRYRVN): Qliphoth of ♎

549

	מורגש (MVRGSh): Moral
	רוח סערה (RVCh Sa'aRH): Ventus turbinis

550

	נשר (NShR): Aquila; decidua. [Vide K.D. L.C.K. p. 600; connect with no. 496, Malkuth]
	שבט ברזל (ShBT BRZL): A rod of iron. [Ps. ii.]
	שרטיאל (ShRTYAL): L.A. Angel of ♌
	שרימ (ShRYM): Principes
	תנינמ (ThNYNM): Dragons. (Restricted.) [Ps. lxxiv. 13]

551


552

	חמדת ימימ (ChMDTh YMYM): Desiderium dierum

553

	תנינ גדול (ThNYN GDVL): Draco magnus

554

	מרחוש (MRChVSh): Day Demon of 2nd Dec. ♓

555

	עפתה (a'aPThH): Obscurity

556

	רשימו (RShYMV): Mark, vestige, footstep
	שרונ (ShRVN): Sharon. [Cant. ii. 1]

557

	ראשונ (RAShVN): The First

558


559


560

	דרושימ (DRVShYM): 
	מי מנוחות (MY MNVChVTh): Waters of quiet
	נקודת (NQVDTh): Puncta
	תמנע (ThMNa'a): A Duke of Edom
	תנינימ (ThNYNYM): Dragons

561

	אתקינ (AThQYN): Cain
	דצניותא (DTzNYVThA): Concealed Mystery

562

	ראשונה (RAShVNH): Primordial

563

	נטילת ידימ (NTYLTh YDYM): Lotio manuum
	סגרש (SGRSh): Angel of 1st Dec. ♊

564

	אבנ הראשה (ABN HRAShH): Lapis capitalis
	ויהי האדמ לנפש חיה (VYHY HADM LNPSh ChYH): [I.R.Q. 941.] "And the Adam was formed into a living Nephesh"
	חלמ יסודות (ChLM YSVDVTh): Sphere of Malkuth

565

	קטנות (QTNVTh): Parvitatio
	שוטרימ (ShVTRYM): Praetoriani

566

	ישרונ (YShRVN): A valley; a plain
	נקודות (NQVDVTh): Puncta
	[70] ס:ו:ד: (S:V:D:): [SMK + VV + DLTh, SVD = a secret, spelt in full
	צלמות (TzLMVTh): The Shadow of Death; Hell of Netzach
	תיקונ (ThYQVN): Redintegratio, configuratio, depositio, conformatio, restoratio, restitutio

567

	ראשוני (RAShVNY): Firstborn

568


569

	אצבעות (ATzBa'aVTh): Fingers

570

	נפתלי (NPThLY): Naphtali
	ערש (a'aRSh): Lectus
	עשר (a'aShR): Ten
	רישינ (RYShYN): Heads
	רעש (Ra'aSh): Concussion, earthquake
	רשע (RSha'a): [Vide K.D. L.C.K. p. 691]
	שער (Sha'aR): Gate; the Door

571

	הררי ציונ (HRRY TzYVN): The mountains of Zion
	מתקלא (MThQLA): Balance

572

	[92] יהוה אלהיכ (YHVH ALHYK): A chastening GOD. [Deut. xxviii. 58.] [HB:K counted as final]
	ישורונ (YShVRVN): Jeschurun
	יתעצב (YTha'aTzB): He was touched. [I.R.Q. 1117]
	מתקבל (MThQBL): Active
	פורפור (PVRPVR): Day Demon of 1st Dec. ♓

573


574

	ירחשונ (YRChShVN): Chaldee. [Hath a general meaning of movement. S.D. p. 87]

575

	באר שבע (BAR ShBa'a): Beerschebha, Fons Septenarii. [2 Sam. xxiv. 7 --- Gen. xxi. 31.] [Vide K.D. L.C.K. p. 183]
	ויאמר אלהימ יהי אור (VYAMR ALHYM YHY AVR): "And the GODS said, Let there be Light"

576

	מקלות (MQLVTh): Wands
	עשור (a'aShVR): The tenth

577

	טמירה דטמרינ (TMYRH DTMRYN): The Concealed of the Concealed; a name of GOD most High

578


579

	חצות לילה (ChTzVTh LYLH): Media nox
	ערב זרק (a'aRB ZRQ): Qliphoth of Netzach
	תענוגימ (Tha'aNVGYM): Sons of Adam

580

	עשיר (a'aShYR): Rich
	עתיק (a'aThYQ): Ancient
	שעיר (Sha'aYR): "Le bouc emissaire"; shaggy, hairy. [Levit. xvi. 22]
	שרפ (ShRP): Angel of Fire

581

	עתיקא (a'aThYQA): The Ancient One
	שעורה (Sha'aVRH): Barley

582


583


584


585

	אלהימ צבאות (ALHYM TzBAVTh): The GODS of Battle (lit. of Hosts); the Divine Name of Hod
	תקיעה (ThQYa'aH): [Vide K.D. L.C.K. p. 386]

586

	שופר (ShVPR): War-trumpet

587

	פוראש (PVRASh): Day Demon of 1st Dec. ♒

588


589

	אב לשונ ענפ (AB LShVN a'aNP): Viror. [Vide K.D. L.C.K. p. 15]

590

	צלעת (TzLa'aTh): Rib. [Gen. ii. 22]

591


592


593


594

	אבנ ישראל (ABN YShRAL): The Stone of Israel. [Gen. xlix. 24]

595


596

	ירושלימ (YRVShLYM): Jeruschalim

597


598

	עונותינו (a'aVNVThYNV): Our iniquities

599


600

	פליאות חכמה (PLYAVTh ChKMH): Mirabilia, vel occulta sapientiae
	ציצית (TzYTzYTh): Peniculamentum, fimbria peniculata
	קשר (QShR): A knot, ligature
	שרק (ShRQ): Red
	שש (ShSh): Six; marble

601


602

	אור פשוט (AVR PShVT): Lux simplicissima
	צחצחות (TzChTzChVTh): Brightness; splendores
	קצוות (QTzVVTh): Extremitates

603

	שלהבירונ (ShLHBYRVN): Qliphoth of ♌

604

	אגרת (AGRTh): Congeries; epistola
	ישראל סבא (YShRAL SBA): Israel Senex

605

	אדרת (ADRTh): Magnificentia
	גברת (GBRTh): [Vide K.D. L.C.K. p. 226]

606

	ישרצו (YShRTzV): Let them bring forth
	עצמות (a'aTzMVTh): Ipseitas, seu ipsa essentia. [Vide K.D. L.C. K. pp. 571, 631]
	קשור (QShVR): Nexus, ligature
	רות (RVTh): Ruth
	תור (ThVR): A turtle-dove

607

	אדמ הראשונ (ADM HRAShVN): Adam Primus
	הרי בשמימ (HRY BShMYM): The mountains of spices. [Cant. viii. 14]
	זרת (ZRTh): A span, palm. [Lit. "the little finger"]

608

	בבא בתרא (BBA BThRA): The last Gate. [Vide K.D. L.C.K. p. 184]
	חתר (ChThR): [Vide K.D. L.C.K. p. 640]

609


610

	אגורת (AGVRTh): Numulus argenteus
	אתרוג (AThRVG): Citrus, malum citrum; (lust and desire). [Vide K.D. L.C.K. p. 178]
	מעשר (Ma'aShR): Tenth

611

	יראת (YRATh): "The Fear" of the LORD. [Ps. cxi. 10]
	תורה (ThVRH): The Law. (Occasional spelling)

612

	ברית (BRYTh): (The covenant) --- Day Demon of 1st Dec. ♑. [Ps. xxv. 14]

613
The number of the Divine Precepts
	את האור (ATh HAVR): The Quintessence of Light
	משה רבינו (MShH RBYNV): Moses, our Rabbi
	תריג (ThRYG): [Vide K.D. L.C.K. p. 179]

614


615


616

	שימירונ (ShYMYRVN): Qliphoth of ♓
	תירו (ThYRV): The Five Books of Moses; the Law on Sinai. Cf. Tarot

617

	גבורות (GBVRVTh): "Mighty acts." (Plur. of "Strength.") [Ps. cvi. 2]
	עמודי האש והעננ (a'aMVDY HASh VHa'aNN): Columnae Nubis et Ignis
	רהבית (RHBYTh): A King of Edom

618

	ריבות (RYBVTh): Contentiones

619

	אחרית (AChRYTh): Novissimum

620

	חכמה בינה ודעת (ChKMH BYNH VDa'aTh): Chokmah, Binah, Daath; the first descending triad
	כתר (KThR): The Crown: Kether
	משפר (MShPR): Angel of 3rd Dec. ♍
	צפנת (TzPNTh): [Vide Ps. xxxi. 20]
	שערימ (Sha'aRYM): The Doors
	ששכ (ShShK): [Temurah of LBB]

621

	אבחת חרב (ABChTh ChRB): Mucro gladii
	אורחות (AVRChVTh): By-paths. Vide no. 1357]

622
[Vide I.R. G. 234]
	ברכת (BRKTh): Blessings
	מצולות ימ (MTzVLVTh YM): Profunda Maris. [Samael et Uxor Eius]
	רחובות (RChVBVTh): Latitudines; Rechoboth

623

	ברייתא (BRYYThA): Barietha; Doctrina extranea; conclusio extra Jeruschalem facta

624

	ובריתו (VBRYThV): His Covenant. [Ps. xxv. 14]
	חירות (ChYRVTh): Liberty
	נחשירונ (NChShYRVN): Qliphoth of ♐

625
= 5 to the 4th power
	הרי אררט (HRY ARRT): The Mountain of Ararat

626

	עשרונ (a'aShRVN): The tenth portion

627


628

	[207] א:ו:ר: (A:V:R:): Light. [Spelt in full, with HB:V as VA]
	ברכות (BRKVTh): Blessings

629

	שופר גדול (ShVPR GDVL): The great trumpet

630

	סערש (Sa'aRSh): Angel L.T.D. of ♊
	רוחא קדישא (RVChA QDYShA): The Holy Spirit
	שלש (ShLSh): 
	שרפימ (ShRPYM): Angels of Geburah, and of Kether of Briah

631

	דצניעותא (DTzNYa'aVThA): Concealed Mystery

632


633

	[207] א:ו:ר: (A:V:R:): Light. [Spelt in full, when HB:V = VV]
	זכר ונקבה בראמ (ZKR VNQBH BRAM): [Gen. v. 2]

634


635


636

	צפרירונ (TzPRYRVN): Qliphoth of ♍

637

	פורנאש (PVRNASh): Day Demon of 3rd Dec. ♑
	שאלוש (ShALVSh): Day Demon of 1st Dec. ♎

638


639

	עצ הדעת (a'aTz HDa'aTh): The Tree of Knowledge

640

	כוס תנחומימ (KVS ThNChVMYM): The Cup of Consolations
	שליש (ShLYSh): Third. [Vide K.D. L.C.K. p. 719]
	שמש (ShMSh): ☉; Sphere of ☉
	תמר (ThMR): Palm of the hand; palm-tree

641

	אמרת (AMRTh): Dema purpureum
	ירתאל (YRThAL): Angel of 9 W.
	מארת (MARTh): "Lights"; defective. [S.D. 142]

642

	פורשונ (PVRShVN): Day Demon of 2nd Dec. ♏

643

	[207] א:ו:ר: (A:V:R:): Light. [Spelt in full, when HB:V = VYV]
	גבורות יהוה (GBVRVTh YHVH): Severities of TETRAGRAMMATON
	כוס של ברכה (KVS ShL BRKH): The Cup of Benedictions

644
(12 x 13 x 4) + 20 = number of letters in the five tablets of Enoch. [Vide Equinox VII]

645

	משרקה (MShRQH): A King of Edom

646

	[86] אלהימ (ALHYM): Elohim [HB:M counted as Final]
	מותר (MVThR): Licitum
	משוש (MShVSh): Rejoicing

647

	מארות (MARVTh): Lights

648


649

	תרדמה (ThRDMH): Trance, deep sleep. [Vide no. 244]

650

	נתר (NThR): Nitre

651

	תמורה (ThMVRH): Temurah

652


653


654


655


656

	שושנ (ShVShN): A rose, lily. [Vide no. 706]
	ששונ (ShShVN): Delight, joy
	תנור (ThNVR): A furnace

657

	ותרודיאל (VThRVDYAL): Angel of 3rd Dec. ♏
	זלברחית (ZLBRChYTh): Zelbarachith; ♌

658


659


660

	ניציצית (NYTzYTzYTh): Scintillae
	קשרינ (QShRYN): Zones; members
	תינר (ThYNR): 

661

	אסתר (ASThR): Esther
	ישטולוש (YShTVLVSh): Day Demon of 3rd Dec. ♓
	שושנה (ShVShNH): Crinorrhodon (vide K.D. L.C.K. p. 708); a rose
	תרגבונ (ThRGBVN): Angel L.T.D. of ♎

662

	אכתריאל (AKThRYAL): Corona Dei

663

	אבני שש (ABNY ShSh): Lapides marmoris. [Vide Zohar, pt. I. fol. 34. col. 134]
	זמירות (ZMYRVTh): Cantio

664


665

	בית הרחמ (BYTh HRChM): The Womb

666
☉. The Number of THE BEAST
	אלהיסטהר ה כרעולהי (ALHYSTHR H KRa'aVLHY): Aleister E. Crowley
	אליסטיר קרולי (ALYSTYR QRVLY): Aleister Crowley [Rabbi Battiscombe Gunn's v.l.]
	[117] הא x אלפ (HA x ALP): The number 5, which is 6 (HB:HA), on the Grand Scale
	נשימירונ (NShYMYRVN): Qliphoth of ♓
	סורת (SVRTh): Spirit of ☉
	עממו סתנ (a'aMMV SThN): Ommo Satan, the 'Evil Triad' of Satan-Typhon, Apophras, and Besz
	שמ יהשוה (ShM YHShVH): The Name Jesus

667

	שמנ למאור (ShMN LMAVR): The oil for lighting

668

	סחרת (SChRTh): Negotiatrix

669


670

	ערת (a'aRTh): 
	עתר (a'aThR): Deprecatus

671

	עושה פרי (a'aVShH PRY): Ferens fructum
	תערא (Tha'aRA): The Law
	תרעא (ThRa'aA): The Gate
	[65] א:ד:נ:י: (A:D:N:Y:): Adonai. [Spelt in full]

672


673


674

	סוחרת (SVChRTh): [Vide K.D. L.C.K. p. 395]

675

	היכל עצסשמימ (HYKL a'aTzSShMYM): Briatic Palace of Netzach

676

	[116] גלגלימ (GLGLYM): Artificial. [HB:M final]
	עתור (a'aThVR): Angel L.T.D. of ♒

677


678

	ערבות (a'aRBVTh): Planities coeli; Assiatic Heaven of 1st palace

679

	אבנ מעולפת (ABN Ma'aVLPTh): The chrysolite stone. [Cant. v. 14]

680

	פרת (PRTh): Phrath, one of the four rivers of Eden

681

	תרועה (ThRVa'aH): Joyful noise; battle-cry; the sound (of a trumpet)

682

	ערבית (a'aRBYTh): Of the evening; of the West

683


684


685


686


687


688


689


690

	מנרת (MNRTh): The candlestick
	תמרימ (ThMRYM): Palm-trees

691


692

	רביעית (RBYa'aYTh): The fourth portion

693

	גפרית (GPRYTh): Sulphur

694


695

	עולמ מורגש (a'aVLM MVRGSh): The Moral World

696


697

	ארמנות (ARMNVTh): Castella munita; domus munitae

698


699


700

	כפרת (KPRTh): The Mercy Seat
	פרכת (PRKTh): The Veil of the Holy
	שת (ShTh): Seth

701

	אשת (AShTh): [Deut. xxiii. 1]
	והנה שלשה (VHNH ShLShH): "And lo! three men." [These be Michael, Gabriel and Raphael, --- ALV-MYKAL-GBRYAL-VRPAL]
	נפילת אפימ (NPYLTh APYM): Prolapsus in faciem

702

	שבת (ShBTh): Sabbathum quies

703

	מסגרת (MSGRTh): Taenia
	סאתאריאל (SAThARYAL): Qliphoth of Binah

704

	ארבעתאל (ARBa'aThAL): "Arbatel." [The "Arbatel" of Magic, by Pietro di Abano]
	נתדוריגאל (NThDVRYGAL): Angel L.T.N. of ♓

705

	אבנימ מפולמות (ABNYM MPVLMVTh): The stones of dampness. [Job xxviii. 3]

706

	כפורת (KPVRTh): Propitiatorium
	שושנימ (ShVShNYM): "Lilies" (I.R.Q. 878), or "Roses" (von Rosenroth)

707


708

	מלאכ הברית (MLAK HBRYTh): The Angel of the Covenant
	שחת (ShChTh): Perdition

709
The Seven Double Letters
	[402] ב:ת (B:Th): HB:B, HB:G, HB:D, HB:K, HB:P, HB:R, H

710

	מערת (Ma'aRTh): Spelunca
	שית (ShYTh): Six. (Ch.)

711


712


713

	שבתאי (ShBThAY): Sphere of ♄
	תשובה (ThShVBH): Conversio

714


715

	נסתרה (NSThRH): Secret
	קטורת (QTVRTh): Perfumed, fumigated

716

	ושתי (VShThY): Vaschti. [Est. i. 9]
	מטרוניתא (MTRVNYThA): Matrona

717


718


719


720
:6
	חשבתי (ChShBThY): 
	שררכ (ShRRK): Thy Navel. [Cant. vii. 3]

721

	נקדה ראשונה (NQDH RAShVNH): The Primordial Point

722

	קול שופר (QVL ShVPR): The voice of the trumpet

723


724

	אחרית הימימ (AChRYTh HYMYM): The end of the days

725


726


727


728

	תשכח (ThShKCh): [Vide K.D. L.C.K. p. 506]

729
= 9 to the 3rd power = 3 to the 6th power
	קרע שטנ (QRa'a ShTN): [Vide K.D. L.C.K. p. 505]

730


731


732


733

	רישא הוורה (RYShA HVVRH): The white head: a title of GOD most High

734

	שתלד (ShThLD): To bring forth

735

	במרצתג (BMRTzThG): Tiphareth, 42-fold Name in Yetzirah

736

	עקלקלות (a'aQLQLVTh): Tortuosae

737

	שלהבת (ShLHBTh): (Live coal) --- Blaze, flame
	שת הבל (ShTh HBL): 

738


739


740


741

	[91] אמנ (AMN): (HB:N counted as Final) Amen: see 91
	אמתש (AMThSh): The four letters of the elements; hence a concealed YHVH

742

	ארונ העדות (ARVN Ha'aDVTh): The Ark of the Testimony. [Lit. "of tremblings," scil. "vibrations"]

743


744


745


746

	שמות (ShMVTh): The Names

747

	קול התור (QVL HThVR): The voice of the turtle- dove. [Cant. ii. 12]

748

	שמנ המשחה (ShMN HMShChH): The oil of Anointment

749


750

	לשכת (LShKTh): Conclave
	עפרת (a'aPRTh): Lead

751

	איש תמ (AYSh ThM): Vir integer

752

	שאתאנ (ShAThAN): Satan

753
Abraham and Sarah. [Either spelling. Vide 243, 248, 505, & 510]

754


755


756

	ספירות (SPYRVTh): Emanations: numbers
	שנות (ShNVTh): Years

757

	אשכלות (AShKLVTh): Netzach and Hod

758

	משחית (MShChYTh): Perdition
	נחשת (NChShTh): Copper ore; bronze

759

	אבקת רוכל (ABQTh RVKL): Pulvis aromatarii

760

	מקביל ומתקבל (MQBYL VMThQBL): "Both Active and Passive"; said in the Qabalah concerning the Sephiroth
	עצרת (a'aTzRTh): Confinement, detention
	קרעשמנ (QRa'aShMN): Yesod, 42-fold Name in Yetzirah

761


762


763


764


765


766


767


768


769


770

	משוטטות (MShVTTVTh): Going forth. [Said of the Eyes of TETRAGRAMMATON]
	עקרת (a'aQRTh): Unfruitful, barren

771

	שלתיאל (ShLThYAL): L.A. Angel of ♍

772

	שבע שנימ (ShBa'a ShNYM): Septennium

773

	אבנ השתיה (ABN HShThYH): Lapis, seu canalis lapideus Potationis

774

	בת שבע (BTh ShBa'a): Filia Septenarii

775

	דקרדינותא (DQRDYNVThA): [Vide no. 934]

776


777
"The Flaming Sword," if the path from Binah to Chesed be taken as = 3. For HB:G connects Arikh Anpin with Zauir Anpin
	אחת רוח אלהימ חיימ (AChTh RVCh ALHYM ChYYM): One is the Ruach of the Elohim of Lives
	עולמ הקליפות (a'aVLM HQLYPVTh): The World of Shells

778


779


780

	שכנתי (ShKNThY): I dwell, have dwelt. ("Not" written.) [I.R.Q. 1122; Prov. viii. 12]
	שפת (ShPTh): Shore, bank

781


782


783


784

	שיחרירונ (ShYChRYRVN): Qliphoth of ♋

785


786

	פשות (PShVTh): Smooth

787


788

	חכמה נסתרה (ChKMH NSThRH): The Secret Wisdom: i.e., The Qabalah. [Vide 58]

789


790

	שיכנתי (ShYKNThY): My presence. [I.R.Q. 1122; Prov. xii.]

791


792

	ישועות (YShVa'aVTh): [Vide K.D. L.C.K. p. 460, and Ps. xviii. 51]

793


794


795


796

	כוס התרעלה (KVS HThRa'aLH): Calix horroris

797


798

	הר גריזימ והר עיבל (HR GRYZYM VHR a'aYBL): Mount Gaerisim and mount Ebal. [Deut. xi. 29]
	שביעיות (ShBYa'aYVTh): Consisting of Seven

799


800

	קשת (QShTh): A bow; ♐. The three Paths leading from Malkuth; hence much symbolism of the Rain- bow of Promise

801


802
401 x 2 = The Reflection of 401 which is HB:ATh, GR:alpha & GR:omega
	ישיבה שלמ עלה (YShYBH ShLM a'aLH): Consessus vel Schola vel Academia Superna. [Refers to A ∴ A ∴, the three grades which are above the Abyss. Vide K.D. LO.C.K. p. 461]
	נקמ ברית (NQM BRYTh): Vindicta foederis
	תבת (ThBTh): An ark, as of Noah or of Moses

803


804


805


806


807


808

	נחשתנ (NChShThN): "A piece of brass" --- the Brazen Serpent

809


810

	יתת (YThTh): A Duke of Edom
	שמינית (ShMYNYTh): Octava

811


812


813

	אותות (AVThVTh): Signa
	אראריתא (ARARYThA): Ararita; a name of GOD which is a Notarigon of the sentence AChD RASh: AChDVThV RASh YYChVDVThV: ThMVRThV AChD. "One is His Beginning; one is His Individuality; His Permutation One
	ויאמר אלהימ יהי אור ויהי אור (VYAMR ALHYM YHY AVR VYHY AVR): [Gen i. 3]

814


815

	אחשורש (AChShVRSh): Ahasuerus

816


817


818


819


820


821


822


823

	אבנ משכית (ABN MShKYTh): Lapis effigiei seu figuratus. [Lev. xxvi. 1.]
	אותיות (AVThYVTh): Litterae

824


825


826


827


828


829


830

	יששכר (YShShKR): Issachar
	תלת (ThLTh): Three ("?" third)

831


832

	לבנת ספיר (LBNTh SPYR): Albedo Crystalli

833

	חיות הקדש (ChYVTh HQDSh): Choir of Angels in Kether
	עובה על רפשע (a'aVBH a'aL RPSha'a): Transiens super prevaricatione

834


835

	זרועות עולמ (ZRVa'aVTh a'aVLM): Brachia Mundi

836


837

	תת זל (ThTh ZL): The profuse giver. [Cf. the Egyptian word Tat.]
	[277] למרבה (LMRBH): [HB:M counted as Final. Vide 277. This "is" written]

838


839


840


841

	תהלות (ThHLVTh): Laudes

842


843


844


845

	כב אותיות (KB AVThYVTh): 
	שמנ השפע (ShMN HShPa'a): Oleum influxus

846


847


848


849

	מוצאי שבת (MVTzAY ShBTh): Exitus Sabbathi

850

	תכלת (ThKLTh): Blue; perfection
	תמתי (ThMThY): My perfect one. ("Not" written.) [Cant. v. s.] Vide 857

851

	נשמתהונ (NShMThHVN): Souls. [I.R.Q. 1052 et seq.]

852

	משבצות זהב (MShBTzVTh ZHB): Occellata Aurea; Netzach and Hod receiving influence from Geburah

853

	שדה תפוחימ (ShDH ThPVChYM): An orchard

854


855


856

	תיומת (ThYVMTh): Summitatis bifidae in Lulabh

857

	תאומתי (ThAVMThY): My twin-sister. ["Is" written]

858

	אתה גבור לעולמ אדני (AThH GBVR La'aVLM ADNY): "To Thee be Power unto the Ages, my Lord" [Vide 35 s.v. HB:AGLA]

859

	תפלה של יד (ThPLH ShL YD): Inunctio, copula, phy- lacterium, ornamentumve manus. [Connect with HB:NShR]

860


861


862


863


864

	אשת זנונימ (AShTh ZNVNYM): The Woman of Whoredom
	שמש וירח (ShMSh VYRCh): ☉ and ☽

865


866

	ירכתי צפונ (YRKThY TzPVN): Latera aquilonis

867


868

	נתיבות (NThYBVTh): Semitae

869

	תגרירונ (ThGRYRVN): Qliphoth of Tiphareth

870

	תריסר (ThRYSR): Twelve

871


872

	שבעת ימימ (ShBa'aTh YMYM): Septiduum

873


874


875


876


877


878


879


880

	השסהתימני (HShSHThYMNY): A King of Edom

881

	קרקפתא (QRQPThA): Os cranii, cranium

882

	רחובות הנהר (RChVBVTh HNHR): Dilationes fleminis

883

	אור מתנוצצ (AVR MThNVTzTz): Lux oriens

884

	תועבות (ThVa'aBVTh): Domination

885


886


887


888


889


890

	מערת המכפלה (Ma'aRTh HMKPLH): Spelunca duplex

891


892

	אפיסת הרעיונ (APYSTh HRa'aYVN): Defectus cogitationis

893


894


895


896


897


898


899


900


901


902

	היכל לבנת הספיר (HYKL LBNTh HSPYR): Briatic Palace of Jesod --- Malkuth

903

	אשאראת (AShARATh): Secret name of Cagliostro

904


905


906

	רשות (RShVTh): Licentia. [Vide K.D. L.C.K. p. 693]
	תולעת (ThVLa'aTh): Vermis

907


908


909


910

	רשית (RShYTh): Beginning. [Vide I.Z.Q. 547, et seq.]

911

	בארשחת (BARShChTh): Hell of Tiphareth
	ראשית (RAShYTh): Beginning
	שארית (ShARYTh): Remnant

912

	שורות (ShVRVTh): Pl. of 506 HB:ShVR q.v.

913

	בראשית (BRAShYTh): Berashith; "in the Beginning." [With "small" B.] [Vide A Note on Genesis, Equinox II 163-185, and 2911]

914


915


916


917


918


919


920


921

	הסתכלות (HSThKLVTh): Nekudoth; intuitus aspectus. [Vide K.D. L.C.K. p. 547]

922


923


924


925


926


927


928


929

	אוצרות צפונ (AVTzRVTh TzPVN): Gazophylacia Septentrionis
	היכל קודש קדשימ (HYKL QVDSh QDShYM): Briah, the Palace of the Supernals therein

930


931


932

	עצ הדעת טוב ורע (a'aTz HDa'aTh TVB VRa'a): The Tree of the Knowledge of Good and Evil

933

	ברית המעור (BRYTh HMa'aVR): Foedus nuditatis vel Sabbathi vel arcus

934

	בוצינא דקרדינותא (BVTzYNA DQRDYNVThA): Coruscatio vehementissima; splendor exactissime dimeticus

935

	סבת הסבות (SBTh HSBVTh): The Cause of causes
	תענוגות (Tha'aNVGVTh): [Vide Eccles. ii. 8, & S.D. v. 79]

936

	[620] כ:ת:ר: (K:Th:R:): Kether. [Spelt in full]

937


938


939


940


941

	משראת (MShRATh): Angel of 1st Dec. ♐

942


943


944


945

	נקדה פשות (NQDH PShVTh): The small point: a title

946


947

	מתראוש (MThRAVSh): Angel of 1st Dec. ♋

948


949


950

	המתהפכת (HMThHPKTh): [Vide no. 1204]

951

	ספר תורה (SPR ThVRH): The Book of the Law

952


953

	אשמורות (AShMVRVTh): Vigiliae

954


955


956


957

	משחא רבות (MShChA RBVTh): Unguentum Magnificentiae

958


959


960

	חצוצרות כספ (ChTzVTzRVTh KSP): Tabuae argenteae

961


962


963

	[30] א:כה:ד: (A:CH:D:): Achad; unity. [Spelt fully]
	עטרת עטרה (a'aTRTh a'aTRH): Garland, Crown; a little wreath [Vide K.D. L.C.K. p. 614

964

	זכרונ תרועה (ZKRVN ThRVa'aH): Memoriale iubilationis. [Note Root HB:ZKR, 227 q.v. showing phallic nature of this 'memorial']

965


966


967


968


969


970

	תרשיס (ThRShYS): Angel of Water

971

	שמ המפורש (ShM HMPVRSh): Shemhamphorasch, the 'Divided Name' of GOD

972


973


974


975


976


977


978


979


980


981


982


983

	קרית ארבע (QRYTh ARBa'a): Urbs Quaternionis

984

	ראשית חכמה (RAShYTh ChKMH): The Beginning of Wisdom (is The Wonderment at TETRAGRAMMATON. Psalms).

985


986

	התקפתא (HThQPThA): Vehementia; obiectio rigorosa

987


988

	ברית שלומ (BRYTh ShLVM): Foedus pacis

989

	רועה בשושנימ (RVa'aH BShVShNYM): Pascens inter Lilia

990


991


992

	משוש כל הארצ (MShVSh KL HARTz): The joy of the whole Earth. [Vide no. 296]

993


994


995


996

	עתיקא קדישא (a'aThYQA QDYShA): The Most Holy Ancient One

997


998

	ברית לשונ (BRYTh LShVN): Foedus linguae

999


1000

	ששת (ShShTh): [Vide no. 1100]
	תשרק (ThShRQ): A Qabalistic Method of Exegesis; "spelling Qabalistically backward"

1001


1002

	שפת היאור (ShPTh HYAVR): The bank of a stream

1003


1004


1005


1006

	תרות (ThRVTh): The Law

1007

	תארות (ThARVTh): TAROT. [But vide 671]

1008


1009


1010


1011


1012


1013


1014


1015


1016

	יותרת (YVThRTh): [Vide no. 1047]

1017

	אשישות (AShYShVTh): Vasa vitrea, langenae, phiale

1018


1019


1020


1021


1022


1023


1024
= 5th Rt. 10th Rt 4 to the 5th power = 2 to the 10th power
	נחשתירונ (NChShThYRVN): Qliphoth of ♍

1025

	תעלומות חכמה (Tha'aLVMVTh ChKMH): Absconsiones sapientiae

1026


1027


1028


1029


1030


1031


1032

	ראשית הגלגלימ (RAShYTh HGLGLYM): Sphere of Primum Mobile

1033


1034


1035


1036


1037


1038


1039


1040


1041


1042


1043


1044


1045


1046


1047

	יותרת הכבד (YVThRTh HKBD): Diaphragma supra hepar (vel hepatis)

1048


1049


1050


1051


1052


1053


1054


1055


1056

	שושנת (ShVShNTh): The lily

1057


1058


1059


1060

	[410] משכנ (MShKN): The Tabernacle [HB:N final]

1061

	אסתתר (ASThThR): 
	ויפח באפיו נשמת חיימ (VYPCh BAPYV NShMTh ChYYM): [Vide I.R.Q. 939]

1062


1063


1064


1065


1066


1067


1068


1069


1070


1071


1072


1073


1074


1075


1076


1077


1078


1079


1080


1081

	תפארת (ThPARTh): Tiphareth

1082


1083


1084


1085


1086


1087


1088


1089


1090


1091

	חבצלת השרונ (ChBTzLTh HShRVN): The Rose of Sharon

1092


1093


1094


1095


1096


1097


1098


1099


1100

	ששת ימימ (ShShTh YMYM): Sextiduum

1101


1102


1103


1104


1105


1106

	מתנ התורה (MThN HThVRH): The giving of the Law

1107


1108


1109


1110


1111


1112


1113


1114


1115


1116


1117


1118


1119


1120


1121


1122


1123


1124


1125


1126


1127


1128


1129


1130


1131


1132


1133


1134


1135


1136


1137


1138


1139


1140


1141


1142


1143


1144


1145


1146

	צנתרות (TzNThRVTh): Jars, globular vessels

1147

	שש משזר (ShSh MShZR): Byssus contorta

1148


1149


1150


1151


1152


1153


1154


1155


1156


1157

	מראות הצובאות (MRAVTh HTzVBAVTh): Specula turmarum

1158


1159


1160


1161


1162


1163


1164


1165


1166


1167


1168


1169


1170


1171


1172


1173

	[523] את יהוה אלהינ (ATh YHVH ALHYN): [With HB:N counted as Final]

1174


1175

	לשכת הגזית (LShKTh HGZYTh): Conclave caesum

1176


1177


1178


1179


1180


1181


1182


1183


1184


1185


1186


1187


1188


1189


1190


1191


1192


1193


1194


1195


1196

	כפות תמרימ (KPVTh ThMRYM): Fasciculi; rami palmarum

1197


1198


1199


1200


1201


1202


1203


1204

	להט חרב המתהפכת (LHT ChRB HMThHPKTh): Flamma gladii versatilis

1205


1206

	נשמתא קדישא (NShMThA QDYShA): The Holy Intelligence
	שקתות (ShQThVTh): A water-trough

1207


1208


1209


1210

	תרשיש (ThRShYSh): Angel of Geburah of Briah

1211


1212


1213


1214


1215


1216


1217


1218


1219

	יוצר בראשית (YVTzR BRAShYTh): Formator eius quod in principiis

1220

	שערימרת (Sha'aRYMRTh): Hell of Hod
	שמנ כתית (ShMN KThYTh): The beaten oil

1221


1222


1223


1224


1225
= ♀.
	עתיקא דעתיקינ (a'aThYQA Da'aThYQYN): The Ancient of the Ancient Ones

1226


1227


1228


1229


1230


1231


1232


1233


1234


1235


1236


1237


1238


1239


1240


1241


1242


1243


1244


1245


1246


1247


1248


1249


1250


1251


1252


1253


1254


1255


1256


1257


1258


1259


1260

	תרשישימ (ThRShYShYM): Angels of Netzach and of Geburah of Briah

1261


1262


1263


1264


1265


1266


1267


1268


1269


1270


1271


1272


1273


1274


1275


1276


1277


1278


1279

	אש מתלקחת (ASh MThLQChTh): Ignis sese reciprocans

1280


1281


1282


1283


1284


1285


1286


1287


1288


1289


1290


1291


1292


1293


1294

	תקות חוט השני (ThQVTh ChVT HShNY): Chorda fili coccini

1295


1296
= 6 to the 4th power. 4 Rt.

1297


1298


1299


1300


1301


1302


1303


1304


1305


1306


1307

	אשתרות (AShThRVTh): Angel L.T.D, of 2nd Dec. ♑, and King-Demon of Geburah

1308


1309


1310


1311


1312


1313


1314


1315


1316


1317


1318


1319


1320


1321
The Lily of the Valleys

1322


1323


1324


1325


1326


1327


1328


1329


1330


1331
3 Rt.

1332


1333


1334


1335


1336


1337


1338


1339


1340


1341


1342


1343


1344


1345


1346


1347


1348


1349


1350
The numerical value of the 9 Paths of the Lesser Beard: viz. HB:N, HB:S, HB:a'a, HB:P, HB:Tz, HB:Q, HB:R, HB:Sh, and HB:Th

1351


1352


1353


1354


1355


1356


1357

	אורחות עקלקלות (AVRChVTh a'aQLQLVTh): Crooked by-paths. [Jud. v. 6]

1358


1359


1360


1361


1362


1363


1364


1365


1366


1367


1368


1369


1370


1371


1372


1373


1374


1375


1376


1377


1378


1379


1380

	שפת שקר (ShPTh ShQR): The lip of the liar

1381


1382


1383


1384


1385


1386


1387


1388


1389


1390


1391


1392


1393


1394


1395


1396


1397


1398


1399


1400

	[401] את (ATh): Chaos, or = HB:ATh, 401 q.v.
	תלת רישינ (ThLTh RYShYN): Tria Capita

1401


1402


1403


1404


1405


1406


1407


1408


1409


1410


1411


1412


1413


1414


1415


1416


1417


1418


1419


1420


1421


1422


1423


1424


1425


1426


1427


1428


1429


1430


1431


1432


1433


1434


1435


1436


1437


1438


1439


1440


1441


1442


1443


1444


1445

	לשאירית נחלתו (LShAYRYTh NChLThV): The remnant of his heritage

1446


1447


1448


1449


1450


1451


1452


1453


1454


1455


1456


1457


1458


1459


1460

	שבת שבתונ (ShBTh ShBThVN): Quies cessationis

1461


1462


1463


1464


1465


1466


1467


1468


1469


1470


1471


1472


1473


1474


1475


1476


1477


1478


1479


1480

	שבע שבתות (ShBa'a ShBThVTh): Septem heptaeterides

1481


1482

	גולות הכותרות (GVLVTh HKVThRVTh): Rotunditates, seu vasa rotunda capitellarum, seu capitella rotunda

1483


1484


1485


1486


1487


1488


1489


1490


1491


1492


1493


1494


1495
The total numerical value of the Paths of the Tree; i.e. of the Beards conjoined; i.e. of the whole Hebrew Alphabet

1496


1497


1498


1499


1500


1501


1502


1503


1504


1505


1506


1507


1508


1509


1510


1511


1512


1513


1514


1515


1516


1517


1518


1519


1520


1521


1522


1523


1524


1525


1526


1527


1528


1529


1530


1531


1532


1533


1534


1535


1536


1537


1538


1539


1540


1541


1542

	שמנ משחת קדש (ShMN MShChTh QDSh): The Oil of the Anointing

1543


1544


1545


1546


1547


1548


1549


1550


1551


1552


1553


1554


1555


1556


1557


1558


1559


1560


1561


1562


1563


1564


1565


1566


1567


1568


1569


1570


1571


1572


1573


1574


1575


1576


1577


1578


1579


1580


1581


1582


1583


1584


1585


1586


1587


1588


1589


1590


1591


1592


1593


1594


1595


1596


1597


1598


1599


1600


1601


1602


1603


1604


1605


1606


1607


1608


1609


1610


1611


1612


1613


1614


1615


1616


1617


1618


1619


1620


1621


1622


1623


1624


1625


1626


1627


1628


1629


1630


1631


1632


1633


1634


1635


1636


1637


1638


1639


1640


1641


1642


1643


1644


1645


1646


1647


1648


1649


1650


1651


1652


1653


1654


1655


1656


1657


1658


1659


1660


1661


1662


1663


1664

	שמנ זיתזכ כתית (ShMN ZYThZK KThYTh): The pure olive oil beaten out

1665


1666


1667


1668


1669


1670


1671


1672


1673


1674


1675


1676


1677


1678


1679


1680


1681


1682


1683


1684


1685


1686


1687


1688


1689


1690


1691


1692


1693


1694


1695


1696


1697


1698


1699


1700


1701


1702


1703


1704


1705


1706


1707


1708


1709


1710


1711


1712


1713


1714


1715


1716


1717


1718


1719


1720


1721


1722


1723


1724


1725


1726


1727


1728


1729


1730


1731


1732


1733


1734


1735


1736


1737


1738


1739


1740


1741


1742


1743


1744


1745


1746


1747


1748


1749


1750


1751


1752


1753


1754


1755

	קדוש קדוש קדוש יהוה צבאות (QDVSh QDVSh QDVSh YHVH TzBAVTh): Holy, Holy, Holy, Lord GOD of Hosts!

1756


1757


1758


1759


1760


1761


1762


1763


1764


1765


1766


1767


1768


1769


1770


1771


1772


1773


1774


1775


1776


1777


1778


1779


1780


1781


1782


1783


1784


1785


1786


1787


1788


1789


1790


1791


1792


1793


1794


1795


1796


1797


1798


1799


1800


1801


1802


1803


1804


1805


1806


1807


1808


1809


1810


1811


1812


1813


1814


1815


1816


1817


1818


1819


1820


1821


1822


1823


1824


1825


1826


1827


1828


1829


1830


1831


1832


1833


1834


1835


1836


1837


1838


1839


1840


1841


1842


1843


1844


1845


1846


1847


1848


1849


1850


1851


1852


1853


1854
::7

1855


1856


1857


1858


1859


1860


1861


1862


1863


1864


1865


1866


1867


1868


1869


1870


1871


1872


1873


1874


1875


1876


1877


1878


1879


1880


1881


1882


1883


1884


1885


1886


1887


1888


1889


1890


1891


1892


1893


1894


1895


1896


1897


1898


1899


1900


1901


1902


1903


1904


1905


1906


1907


1908


1909


1910


1911


1912


1913


1914


1915


1916


1917


1918


1919


1920


1921


1922


1923


1924


1925


1926


1927


1928


1929


1930


1931


1932


1933


1934


1935


1936


1937


1938


1939


1940


1941


1942


1943


1944


1945


1946


1947


1948


1949


1950


1951


1952


1953


1954


1955


1956


1957


1958


1959


1960


1961


1962


1963


1964


1965


1966


1967


1968


1969


1970


1971


1972


1973


1974


1975


1976


1977


1978


1979


1980


1981


1982


1983


1984


1985


1986


1987


1988


1989


1990


1991


1992


1993


1994


1995


1996


1997


1998


1999


2000


2001


2002


2003


2004


2005


2006


2007


2008


2009


2010


2011


2012


2013


2014


2015


2016


2017


2018


2019


2020


2021


2022


2023


2024


2025


2026


2027


2028


2029


2030


2031


2032


2033


2034


2035


2036


2037


2038


2039


2040


2041


2042


2043


2044


2045


2046


2047


2048


2049


2050


2051


2052


2053


2054


2055


2056


2057


2058


2059


2060


2061


2062


2063


2064


2065


2066


2067


2068


2069


2070


2071


2072


2073


2074


2075


2076


2077


2078


2079


2080
☿
	תפתרתרת (ThPThRThRTh): Spirit of ☿

2081


2082


2083


2084


2085


2086


2087


2088


2089


2090


2091


2092


2093


2094


2095


2096


2097


2098


2099


2100


2101


2102


2103


2104


2105


2106


2107


2108


2109


2110


2111


2112


2113


2114


2115


2116


2117


2118


2119


2120


2121


2122


2123


2124


2125


2126


2127


2128


2129


2130


2131


2132


2133


2134


2135


2136


2137


2138


2139


2140


2141


2142


2143


2144


2145


2146


2147


2148


2149


2150


2151


2152


2153


2154


2155


2156


2157


2158


2159


2160


2161


2162


2163


2164


2165


2166


2167


2168


2169


2170


2171


2172


2173


2174


2175


2176


2177


2178


2179


2180


2181


2182


2183


2184


2185


2186


2187


2188


2189


2190


2191


2192


2193


2194


2195


2196


2197
3 Rt.

2198


2199


2200


2201


2202


2203


2204


2205


2206


2207


2208


2209


2210


2211


2212


2213


2214


2215


2216


2217


2218


2219


2220


2221


2222


2223


2224


2225


2226


2227


2228


2229


2230


2231


2232


2233


2234


2235


2236


2237


2238


2239


2240


2241


2242


2243


2244


2245


2246


2247


2248


2249


2250


2251


2252


2253


2254


2255


2256


2257


2258


2259


2260


2261


2262


2263


2264


2265


2266


2267


2268


2269


2270


2271


2272


2273


2274


2275


2276


2277


2278


2279


2280


2281


2282


2283


2284


2285


2286


2287


2288


2289


2290


2291


2292


2293


2294


2295


2296


2297


2298


2299


2300


2301


2302


2303


2304


2305


2306


2307


2308


2309


2310


2311


2312


2313


2314


2315


2316


2317


2318


2319


2320


2321


2322


2323


2324


2325


2326


2327


2328


2329


2330


2331


2332


2333


2334


2335


2336


2337


2338


2339


2340


2341


2342


2343


2344


2345


2346


2347


2348


2349


2350


2351


2352


2353


2354


2355


2356


2357


2358


2359


2360


2361


2362


2363


2364


2365


2366


2367


2368


2369


2370


2371


2372


2373


2374


2375


2376


2377


2378


2379


2380


2381


2382


2383


2384


2385


2386


2387


2388


2389


2390


2391


2392


2393


2394


2395


2396


2397


2398


2399


2400


2401
= 7 to the 4th power

2402


2403


2404


2405


2406


2407


2408


2409


2410


2411


2412


2413


2414


2415


2416


2417


2418


2419


2420


2421


2422


2423


2424


2425


2426


2427


2428


2429


2430


2431


2432


2433


2434


2435


2436


2437


2438


2439


2440


2441


2442


2443


2444


2445


2446


2447


2448


2449


2450


2451


2452


2453


2454


2455


2456


2457


2458


2459


2460


2461


2462


2463


2464


2465


2466


2467


2468


2469


2470


2471


2472


2473


2474


2475


2476


2477


2478


2479


2480


2481


2482


2483


2484


2485


2486


2487


2488


2489


2490


2491


2492


2493


2494


2495


2496


2497


2498


2499


2500


2501


2502


2503


2504


2505


2506


2507


2508


2509


2510


2511


2512


2513


2514


2515


2516


2517


2518


2519


2520


2521


2522


2523


2524


2525


2526


2527


2528


2529


2530


2531


2532


2533


2534


2535


2536


2537


2538


2539


2540


2541


2542


2543


2544


2545


2546


2547


2548


2549


2550


2551


2552


2553


2554


2555


2556


2557


2558


2559


2560


2561


2562


2563


2564


2565


2566


2567


2568


2569


2570


2571


2572


2573


2574


2575


2576


2577


2578


2579


2580


2581


2582


2583


2584


2585


2586


2587


2588


2589


2590


2591


2592


2593


2594


2595


2596


2597


2598


2599


2600


2601


2602


2603


2604


2605


2606


2607


2608


2609


2610


2611


2612


2613


2614


2615


2616


2617


2618


2619


2620


2621


2622


2623


2624


2625


2626


2627


2628


2629


2630


2631


2632


2633


2634


2635


2636


2637


2638


2639


2640


2641


2642


2643


2644


2645


2646


2647


2648


2649


2650


2651


2652


2653


2654


2655


2656


2657


2658


2659


2660


2661


2662


2663


2664


2665


2666


2667


2668


2669


2670


2671


2672


2673


2674


2675


2676


2677


2678


2679


2680


2681


2682


2683


2684


2685


2686


2687


2688


2689


2690


2691


2692


2693


2694


2695


2696


2697


2698


2699


2700


2701


2702


2703


2704


2705


2706


2707


2708


2709


2710


2711


2712


2713


2714


2715


2716


2717


2718


2719


2720


2721


2722


2723


2724


2725


2726


2727


2728


2729


2730


2731


2732


2733


2734


2735


2736


2737


2738


2739


2740


2741


2742


2743


2744


2745


2746


2747


2748


2749


2750


2751


2752


2753


2754


2755


2756


2757


2758


2759


2760


2761


2762


2763


2764


2765


2766


2767


2768


2769


2770


2771


2772


2773


2774


2775


2776


2777


2778


2779


2780


2781


2782


2783


2784


2785


2786


2787


2788


2789


2790


2791


2792


2793


2794


2795


2796


2797


2798


2799


2800


2801


2802


2803


2804


2805


2806


2807


2808


2809


2810


2811


2812


2813


2814


2815


2816


2817


2818


2819


2820


2821


2822


2823


2824


2825


2826


2827


2828


2829


2830


2831


2832


2833


2834


2835


2836


2837


2838


2839


2840


2841


2842


2843


2844


2845


2846


2847


2848


2849


2850


2851


2852


2853


2854


2855


2856


2857


2858


2859


2860


2861


2862


2863


2864


2865


2866


2867


2868


2869


2870


2871


2872


2873


2874


2875


2876


2877


2878


2879


2880


2881


2882


2883


2884


2885


2886


2887


2888


2889


2890


2891


2892


2893


2894


2895


2896


2897


2898


2899


2900


2901


2902


2903


2904


2905


2906


2907


2908


2909


2910


2911


2912


2913


2914


2915


2916


2917


2918


2919


2920


2921


2922


2923


2924


2925


2926


2927


2928


2929


2930


2931


2932


2933


2934


2935


2936


2937


2938


2939


2940


2941


2942


2943


2944


2945


2946


2947


2948


2949


2950


2951


2952


2953


2954


2955


2956


2957


2958


2959


2960


2961


2962


2963


2964


2965


2966


2967


2968


2969


2970


2971


2972


2973


2974


2975


2976


2977


2978


2979


2980


2981


2982


2983


2984


2985


2986


2987


2988


2989


2990


2991


2992


2993


2994


2995


2996


2997


2998


2999


3000


3001


3002


3003


3004


3005


3006


3007


3008


3009


3010


3011


3012


3013


3014


3015


3016


3017


3018


3019


3020


3021


3022


3023


3024


3025


3026


3027


3028


3029


3030


3031


3032


3033


3034


3035


3036


3037


3038


3039


3040


3041


3042


3043


3044


3045


3046


3047


3048


3049


3050


3051


3052


3053


3054


3055


3056


3057


3058


3059


3060


3061


3062


3063


3064


3065


3066


3067


3068


3069


3070


3071


3072


3073


3074


3075


3076


3077


3078


3079


3080


3081


3082


3083


3084


3085


3086


3087


3088


3089


3090


3091


3092


3093


3094


3095


3096


3097


3098


3099


3100


3101


3102


3103


3104


3105


3106


3107


3108


3109


3110


3111


3112


3113


3114


3115


3116


3117


3118


3119


3120


3121


3122


3123


3124


3125
5th Rt.

3126


3127


3128


3129


3130


3131


3132


3133


3134


3135


3136


3137


3138


3139


3140


3141


3142


3143


3144


3145


3146


3147


3148


3149


3150


3151


3152


3153


3154


3155


3156


3157


3158


3159


3160


3161


3162


3163


3164


3165


3166


3167


3168


3169


3170


3171


3172


3173


3174


3175


3176


3177


3178


3179


3180


3181


3182


3183


3184


3185


3186


3187


3188


3189


3190


3191


3192


3193


3194


3195


3196


3197


3198


3199


3200
32x(10 to the 2nd power) The paths of the Whole Tree in excelsis
	[1202] בראשית ברא אלהימ (BRAShYTh BRA ALHYM): 

3201


3202


3203


3204


3205


3206


3207


3208


3209


3210


3211


3212


3213


3214


3215


3216


3217


3218


3219


3220


3221


3222


3223


3224


3225


3226


3227


3228


3229


3230


3231


3232


3233


3234


3235


3236


3237


3238


3239


3240


3241


3242


3243


3244


3245


3246


3247


3248


3249


3250


3251


3252


3253


3254


3255


3256


3257


3258


3259


3260


3261


3262


3263


3264


3265


3266


3267


3268


3269


3270


3271


3272


3273


3274


3275


3276


3277


3278


3279


3280


3281


3282


3283


3284


3285


3286


3287


3288


3289


3290


3291


3292


3293


3294


3295


3296


3297


3298


3299


3300


3301


3302


3303


3304


3305


3306


3307


3308


3309


3310


3311


3312


3313


3314


3315


3316


3317


3318


3319


3320


3321
☽.
	[2201] מלכא בתרשישימ ועד ברוה שהרימ (MLKA BThRShYShYM Va'aD BRVH ShHRYM): The Intelligence of the Intelligences of the ☽
	[2671] שדברשהמעת שרתתנ (ShDBRShHMa'aTh ShRThThN): The Spirit of the Spirits of the ☽

